name	type	tags
.htaccess	tag	.htaccess
.net	tag	.net
.net-3.5	tag	.net-3.5
.net-4.0	tag	.net-4.0
.net-4.5	tag	.net-4.5
.net-attributes	tag	.net-attributes
.net-core	tag	.net-core
.net-framework-version	tag	.net-framework-version
.net-standard	tag	.net-standard
16-bit	tag	16-bit
2048	tag	2048
2sls	tag	2sls
32-bit	tag	32-bit
32bit-64bit	tag	32bit-64bit
3d	tag	3d
64-bit	tag	64-bit
ab-test	tag	ab-test
abbreviation	tag	abbreviation
abc	tag	abc
abi	tag	abi
absolute	tag	absolute
absolute-path	tag	absolute-path
absolute-value	tag	absolute-value
abstract	tag	abstract
abstract-class	tag	abstract-class
abstract-factory	tag	abstract-factory
abstraction	tag	abstraction
academia	tag	academia
access-control	tag	access-control
access-modifiers	tag	access-modifiers
access-specifier	tag	access-specifier
access-token	tag	access-token
accessibility	tag	accessibility
accuracy	tag	accuracy
acf-pacf	tag	acf-pacf
action	tag	action
actionresult	tag	actionresult
actionscript	tag	actionscript
active-directory	tag	active-directory
activemq	tag	activemq
activerecord	tag	activerecord
adaboost	tag	adaboost
adam	tag	adam
adb	tag	adb
add	tag	add
addeventlistener	tag	addeventlistener
administrator	tag	administrator
ado.net	tag	ado.net
adt	tag	adt
aerospike	tag	aerospike
aes	tag	aes
aggregate	tag	aggregate
aggregate-functions	tag	aggregate-functions
aggregation	tag	aggregation
agreement-statistics	tag	agreement-statistics
aic	tag	aic
aix	tag	aix
ajax	tag	ajax
akka	tag	akka
algorithm	tag	algorithm
algorithms	tag	algorithms
alias	tag	alias
alignment	tag	alignment
alphanumeric	tag	alphanumeric
alter-column	tag	alter-column
alter-table	tag	alter-table
amazon-ec2	tag	amazon-ec2
amazon-s3	tag	amazon-s3
amazon-web-services	tag	amazon-web-services
amd	tag	amd
amend	tag	amend
ampersand	tag	ampersand
anaconda	tag	anaconda
analysis	tag	analysis
anchor	tag	anchor
ancova	tag	ancova
and-operator	tag	and-operator
anderson-darling	tag	anderson-darling
android	tag	android
android-3.0-honeycomb	tag	android-3.0-honeycomb
android-5.0-lollipop	tag	android-5.0-lollipop
android-5.1.1-lollipop	tag	android-5.1.1-lollipop
android-6.0-marshmallow	tag	android-6.0-marshmallow
android-7.0-nougat	tag	android-7.0-nougat
android-actionbar	tag	android-actionbar
android-actionbar-compat	tag	android-actionbar-compat
android-activity	tag	android-activity
android-alertdialog	tag	android-alertdialog
android-api-levels	tag	android-api-levels
android-assets	tag	android-assets
android-asynctask	tag	android-asynctask
android-bitmap	tag	android-bitmap
android-browser	tag	android-browser
android-build	tag	android-build
android-button	tag	android-button
android-context	tag	android-context
android-database	tag	android-database
android-debug	tag	android-debug
android-dialog	tag	android-dialog
android-dialogfragment	tag	android-dialogfragment
android-drawable	tag	android-drawable
android-edittext	tag	android-edittext
android-emulator	tag	android-emulator
android-file	tag	android-file
android-fragments	tag	android-fragments
android-fullscreen	tag	android-fullscreen
android-gradle-plugin	tag	android-gradle-plugin
android-gravity	tag	android-gravity
android-image	tag	android-image
android-imageview	tag	android-imageview
android-input-method	tag	android-input-method
android-intent	tag	android-intent
android-intentservice	tag	android-intentservice
android-internet	tag	android-internet
android-layout	tag	android-layout
android-library	tag	android-library
android-lifecycle	tag	android-lifecycle
android-manifest	tag	android-manifest
android-mnc	tag	android-mnc
android-networking	tag	android-networking
android-orientation	tag	android-orientation
android-pendingintent	tag	android-pendingintent
android-permissions	tag	android-permissions
android-recyclerview	tag	android-recyclerview
android-resources	tag	android-resources
android-scripting	tag	android-scripting
android-sdcard	tag	android-sdcard
android-sdk-1.6	tag	android-sdk-1.6
android-sdk-tools	tag	android-sdk-tools
android-service	tag	android-service
android-softkeyboard	tag	android-softkeyboard
android-source	tag	android-source
android-spinner	tag	android-spinner
android-sqlite	tag	android-sqlite
android-studio	tag	android-studio
android-studio-2.0	tag	android-studio-2.0
android-styles	tag	android-styles
android-toast	tag	android-toast
android-toolbar	tag	android-toolbar
android-tools-namespace	tag	android-tools-namespace
android-vibration	tag	android-vibration
android-view	tag	android-view
android-viewpager	tag	android-viewpager
android-widget	tag	android-widget
angular	tag	angular
angular-component-life-cycle	tag	angular-component-life-cycle
angular-components	tag	angular-components
angular-filters	tag	angular-filters
angular-http	tag	angular-http
angular-ng-class	tag	angular-ng-class
angular-ngmodel	tag	angular-ngmodel
angular-observable	tag	angular-observable
angular-promise	tag	angular-promise
angular-services	tag	angular-services
angular-template	tag	angular-template
angular-ui-router	tag	angular-ui-router
angular2-changedetection	tag	angular2-changedetection
angular2-databinding	tag	angular2-databinding
angular2-forms	tag	angular2-forms
angular2-routing	tag	angular2-routing
angular2-template	tag	angular2-template
angularjs	tag	angularjs
angularjs-digest	tag	angularjs-digest
angularjs-directive	tag	angularjs-directive
angularjs-factory	tag	angularjs-factory
angularjs-module	tag	angularjs-module
angularjs-ng-repeat	tag	angularjs-ng-repeat
angularjs-provider	tag	angularjs-provider
angularjs-routing	tag	angularjs-routing
angularjs-scope	tag	angularjs-scope
angularjs-service	tag	angularjs-service
animation	tag	animation
annotations	tag	annotations
anomaly-detection	tag	anomaly-detection
anonymous-methods	tag	anonymous-methods
anova	tag	anova
ansi-colors	tag	ansi-colors
ansi-escape	tag	ansi-escape
ansi-sql-92	tag	ansi-sql-92
aop	tag	aop
apache	tag	apache
apache-camel	tag	apache-camel
apache-commons	tag	apache-commons
apache-flex	tag	apache-flex
api	tag	api
apk	tag	apk
app-config	tag	app-config
app-store	tag	app-store
app-store-connect	tag	app-store-connect
app-transport-security	tag	app-transport-security
append	tag	append
appendfile	tag	appendfile
applet	tag	applet
application	tag	application
application-server	tag	application-server
application-settings	tag	application-settings
application-state	tag	application-state
approximate-inference	tag	approximate-inference
approximation	tag	approximation
appsettings	tag	appsettings
architecture	tag	architecture
archive	tag	archive
argc	tag	argc
argparse	tag	argparse
args	tag	args
argument-passing	tag	argument-passing
argument-unpacking	tag	argument-unpacking
arguments	tag	arguments
argv	tag	argv
arima	tag	arima
arithmetic	tag	arithmetic
arithmeticexception	tag	arithmeticexception
arma	tag	arma
array-difference	tag	array-difference
array-initialization	tag	array-initialization
array-initialize	tag	array-initialize
array-splice	tag	array-splice
arraylist	tag	arraylist
arrays	tag	arrays
arrow-functions	tag	arrow-functions
article	tag	article
artifactory	tag	artifactory
artificial-intelligence	tag	artificial-intelligence
ascii	tag	ascii
ase	tag	ase
ashot	tag	ashot
asn.1	tag	asn.1
asp.net	tag	asp.net
asp.net-3.5	tag	asp.net-3.5
asp.net-4.0	tag	asp.net-4.0
asp.net-ajax	tag	asp.net-ajax
asp.net-core	tag	asp.net-core
asp.net-mvc	tag	asp.net-mvc
asp.net-mvc-3	tag	asp.net-mvc-3
asp.net-web-api	tag	asp.net-web-api
aspect-ratio	tag	aspect-ratio
assemblies	tag	assemblies
assembly	tag	assembly
assert	tag	assert
assertion	tag	assertion
assertions	tag	assertions
assignment-operator	tag	assignment-operator
association-measure	tag	association-measure
association-rules	tag	association-rules
associative	tag	associative
associative-array	tag	associative-array
assumptions	tag	assumptions
asymptotics	tag	asymptotics
async-await	tag	async-await
asynchronous	tag	asynchronous
atomic	tag	atomic
attention	tag	attention
attr	tag	attr
attributes	tag	attributes
auc	tag	auc
augmented-dickey-fuller	tag	augmented-dickey-fuller
authentication	tag	authentication
authenticity-token	tag	authenticity-token
authorization	tag	authorization
auto-import	tag	auto-import
auto-increment	tag	auto-increment
auto-indent	tag	auto-indent
auto-versioning	tag	auto-versioning
autocomplete	tag	autocomplete
autocorrelation	tag	autocorrelation
autoencoders	tag	autoencoders
autofill	tag	autofill
autoformatting	tag	autoformatting
autolayout	tag	autolayout
automated-tests	tag	automated-tests
automatic-algorithms	tag	automatic-algorithms
automatic-differentiation	tag	automatic-differentiation
automatic-properties	tag	automatic-properties
automatic-ref-counting	tag	automatic-ref-counting
autoregressive	tag	autoregressive
autoresetevent	tag	autoresetevent
autoresize	tag	autoresize
autowired	tag	autowired
avd	tag	avd
average	tag	average
average-precision	tag	average-precision
avx	tag	avx
awk	tag	awk
axes	tag	axes
azure-sql-database	tag	azure-sql-database
babeljs	tag	babeljs
back-transformation	tag	back-transformation
backbone.js	tag	backbone.js
background	tag	background
background-color	tag	background-color
background-image	tag	background-image
backport	tag	backport
backpropagation	tag	backpropagation
backup	tag	backup
bagging	tag	bagging
base	tag	base
base-class	tag	base-class
base64	tag	base64
bash	tag	bash
batch-file	tag	batch-file
batch-normalization	tag	batch-normalization
batch-rename	tag	batch-rename
baum-welch	tag	baum-welch
bayes	tag	bayes
bayes-factors	tag	bayes-factors
bayesian	tag	bayesian
bayesian-network	tag	bayesian-network
bayesian-optimization	tag	bayesian-optimization
bcrypt	tag	bcrypt
beautifulsoup	tag	beautifulsoup
behaviorsubject	tag	behaviorsubject
benchmarking	tag	benchmarking
bernoulli-distribution	tag	bernoulli-distribution
bernoulli-process	tag	bernoulli-process
bessels-correction	tag	bessels-correction
beta-binomial	tag	beta-binomial
beta-distribution	tag	beta-distribution
beta-regression	tag	beta-regression
bhattacharyya	tag	bhattacharyya
bias	tag	bias
bias-correction	tag	bias-correction
bias-node	tag	bias-node
bias-variance-tradeoff	tag	bias-variance-tradeoff
bic	tag	bic
big-o	tag	big-o
bigdecimal	tag	bigdecimal
bimodal	tag	bimodal
binary	tag	binary
binary-data	tag	binary-data
binary-operators	tag	binary-operators
binary-semaphore	tag	binary-semaphore
binaryfiles	tag	binaryfiles
binaryreader	tag	binaryreader
bind	tag	bind
binding	tag	binding
binning	tag	binning
binomial	tag	binomial
bioinformatics	tag	bioinformatics
biostatistics	tag	biostatistics
biplot	tag	biplot
birthday-paradox	tag	birthday-paradox
bit-manipulation	tag	bit-manipulation
bit-shift	tag	bit-shift
bitbucket	tag	bitbucket
bitmap	tag	bitmap
bitwise-operators	tag	bitwise-operators
bivariate	tag	bivariate
blind	tag	blind
blocking	tag	blocking
blue	tag	blue
bluebird	tag	bluebird
blup	tag	blup
bonferroni	tag	bonferroni
boolean	tag	boolean
boolean-expression	tag	boolean-expression
boolean-logic	tag	boolean-logic
boost	tag	boost
boosting	tag	boosting
boot2docker	tag	boot2docker
bootstrap	tag	bootstrap
bootstrap-4	tag	bootstrap-4
bootstrapping	tag	bootstrapping
border	tag	border
bots	tag	bots
bounded-wildcard	tag	bounded-wildcard
bounds	tag	bounds
bower	tag	bower
box-jenkins	tag	box-jenkins
boxplot	tag	boxplot
bradley-terry-model	tag	bradley-terry-model
branch	tag	branch
branch-prediction	tag	branch-prediction
branching-and-merging	tag	branching-and-merging
break	tag	break
breakpoints	tag	breakpoints
brokenimage	tag	brokenimage
brownian	tag	brownian
browser	tag	browser
browser-cache	tag	browser-cache
browser-detection	tag	browser-detection
bsts	tag	bsts
buffer	tag	buffer
buffered	tag	buffered
bugs	tag	bugs
build	tag	build
build-automation	tag	build-automation
build-process	tag	build-process
build.gradle	tag	build.gradle
builder	tag	builder
builder-pattern	tag	builder-pattern
bundler	tag	bundler
business-logic-layer	tag	business-logic-layer
button	tag	button
byte	tag	byte
byte-order-mark	tag	byte-order-mark
bytearray	tag	bytearray
bytecode	tag	bytecode
c	tag	c
c#	tag	c#
c#-3.0	tag	c#-3.0
c#-4.0	tag	c#-4.0
c#-5.0	tag	c#-5.0
c++	tag	c++
c++-faq	tag	c++-faq
c++-standard-library	tag	c++-standard-library
c++11	tag	c++11
c++17	tag	c++17
c-preprocessor	tag	c-preprocessor
c64	tag	c64
caching	tag	caching
calibration	tag	calibration
callable	tag	callable
callable-object	tag	callable-object
callback	tag	callback
calloc	tag	calloc
callstack	tag	callstack
canonical-correlation	tag	canonical-correlation
canonical-question	tag	canonical-question
canvas	tag	canvas
capitalization	tag	capitalization
capitalize	tag	capitalize
capturing-group	tag	capturing-group
careers	tag	careers
caret	tag	caret
carriage-return	tag	carriage-return
cart	tag	cart
case	tag	case
case-control-study	tag	case-control-study
case-insensitive	tag	case-insensitive
case-sensitive	tag	case-sensitive
case-when	tag	case-when
cassandra	tag	cassandra
cassini	tag	cassini
casting	tag	casting
categorical-data	tag	categorical-data
categorical-encoding	tag	categorical-encoding
category-theory	tag	category-theory
cauchy	tag	cauchy
causality	tag	causality
cd	tag	cd
cdata	tag	cdata
cdf	tag	cdf
cdn	tag	cdn
censoring	tag	censoring
center	tag	center
centering	tag	centering
central-limit-theorem	tag	central-limit-theorem
central-tendency	tag	central-tendency
certificate	tag	certificate
cgi	tag	cgi
chained-assignment	tag	chained-assignment
change-password	tag	change-password
change-point	tag	change-point
change-scores	tag	change-scores
changeset	tag	changeset
char	tag	char
character	tag	character
character-encoding	tag	character-encoding
character-replacement	tag	character-replacement
character-set	tag	character-set
characteristic-function	tag	characteristic-function
chat	tag	chat
checkbox	tag	checkbox
checked	tag	checked
checked-exceptions	tag	checked-exceptions
checking	tag	checking
checksum	tag	checksum
chemistry	tag	chemistry
chemometrics	tag	chemometrics
cherry-pick	tag	cherry-pick
cherrypy	tag	cherrypy
chi-squared	tag	chi-squared
chmod	tag	chmod
cholesky	tag	cholesky
chunks	tag	chunks
churn	tag	churn
circular-dependency	tag	circular-dependency
circular-statistics	tag	circular-statistics
class	tag	class
class-design	tag	class-design
class-library	tag	class-library
class-method	tag	class-method
class-variables	tag	class-variables
classification	tag	classification
classloader	tag	classloader
classpath	tag	classpath
clean-language	tag	clean-language
clearfix	tag	clearfix
click	tag	click
clickable	tag	clickable
client-side	tag	client-side
climate	tag	climate
clinical-trials	tag	clinical-trials
clipboard	tag	clipboard
cllocationmanager	tag	cllocationmanager
clogit	tag	clogit
clojure	tag	clojure
clone	tag	clone
closures	tag	closures
cloud	tag	cloud
clr	tag	clr
clustered-index	tag	clustered-index
clustered-standard-errors	tag	clustered-standard-errors
clustering	tag	clustering
cmd	tag	cmd
cobertura	tag	cobertura
cocoa	tag	cocoa
cocoa-touch	tag	cocoa-touch
code-cleanup	tag	code-cleanup
code-coverage	tag	code-coverage
code-formatting	tag	code-formatting
code-generation	tag	code-generation
code-metrics	tag	code-metrics
code-organization	tag	code-organization
code-signing	tag	code-signing
code-snippets	tag	code-snippets
code-structure	tag	code-structure
codeigniter	tag	codeigniter
codelens	tag	codelens
codesign	tag	codesign
coding-style	tag	coding-style
coefficient-of-variation	tag	coefficient-of-variation
coffeescript	tag	coffeescript
cohens-d	tag	cohens-d
cohens-kappa	tag	cohens-kappa
cointegration	tag	cointegration
coldfusion	tag	coldfusion
collation	tag	collation
collecting-data	tag	collecting-data
collections	tag	collections
collision-detection	tag	collision-detection
colors	tag	colors
column-width	tag	column-width
com-interop	tag	com-interop
combinations	tag	combinations
combinatorics	tag	combinatorics
combining-p-values	tag	combining-p-values
combobox	tag	combobox
comet	tag	comet
command	tag	command
command-line	tag	command-line
command-line-arguments	tag	command-line-arguments
command-line-interface	tag	command-line-interface
command-line-parsing	tag	command-line-parsing
command-line-tool	tag	command-line-tool
command-prompt	tag	command-prompt
comment-conventions	tag	comment-conventions
comments	tag	comments
commit	tag	commit
commit-message	tag	commit-message
commonjs	tag	commonjs
communication	tag	communication
comparator	tag	comparator
compare	tag	compare
comparison	tag	comparison
comparison-operators	tag	comparison-operators
compilation	tag	compilation
compiled	tag	compiled
compiler-construction	tag	compiler-construction
compiler-errors	tag	compiler-errors
compiler-optimization	tag	compiler-optimization
compiler-version	tag	compiler-version
complete-statistics	tag	complete-statistics
complex-numbers	tag	complex-numbers
complexity-theory	tag	complexity-theory
composer-php	tag	composer-php
composite	tag	composite
composite-key	tag	composite-key
composite-primary-key	tag	composite-primary-key
composition	tag	composition
compositional-data	tag	compositional-data
compression	tag	compression
computational-statistics	tag	computational-statistics
computer-science	tag	computer-science
computer-vision	tag	computer-vision
computing	tag	computing
concat	tag	concat
concatenation	tag	concatenation
concept	tag	concept
concurrency	tag	concurrency
conda	tag	conda
conditional-expectation	tag	conditional-expectation
conditional-operator	tag	conditional-operator
conditional-probability	tag	conditional-probability
conditional-random-field	tag	conditional-random-field
conditional-statements	tag	conditional-statements
conditioning	tag	conditioning
confidence-interval	tag	confidence-interval
config	tag	config
configuration	tag	configuration
configuration-files	tag	configuration-files
confirmatory-factor	tag	confirmatory-factor
confluence	tag	confluence
confounding	tag	confounding
confusion-matrix	tag	confusion-matrix
conjoint-analysis	tag	conjoint-analysis
conjugate-prior	tag	conjugate-prior
connection-string	tag	connection-string
consistency	tag	consistency
console	tag	console
console-application	tag	console-application
console.log	tag	console.log
constants	tag	constants
constexpr	tag	constexpr
constrained-regression	tag	constrained-regression
constraint	tag	constraint
constraints	tag	constraints
construction	tag	construction
constructor	tag	constructor
consulting	tag	consulting
containers	tag	containers
contains	tag	contains
content-script	tag	content-script
content-type	tag	content-type
contingency-tables	tag	contingency-tables
continue	tag	continue
continuous-data	tag	continuous-data
contrast	tag	contrast
contrasts	tag	contrasts
control-characters	tag	control-characters
control-flow	tag	control-flow
controller	tag	controller
controlling-for-a-variable	tag	controlling-for-a-variable
controls	tag	controls
conv-neural-network	tag	conv-neural-network
conventions	tag	conventions
convergence	tag	convergence
converter	tag	converter
converters	tag	converters
convex	tag	convex
convolution	tag	convolution
cookies	tag	cookies
cooks-distance	tag	cooks-distance
copula	tag	copula
copy	tag	copy
copy-and-swap	tag	copy-and-swap
copy-constructor	tag	copy-constructor
copy-paste	tag	copy-paste
copy-protection	tag	copy-protection
copying	tag	copying
corda	tag	corda
coroutine	tag	coroutine
correlation	tag	correlation
correlation-matrix	tag	correlation-matrix
correspondence-analysis	tag	correspondence-analysis
corruption	tag	corruption
cors	tag	cors
cosine-distance	tag	cosine-distance
cosine-similarity	tag	cosine-similarity
cost-maximization	tag	cost-maximization
couchdb	tag	couchdb
count	tag	count
count-data	tag	count-data
countable	tag	countable
coupon-collector-problem	tag	coupon-collector-problem
covariance	tag	covariance
covariance-matrix	tag	covariance-matrix
coverage-probability	tag	coverage-probability
cox-model	tag	cox-model
cp	tag	cp
cpu	tag	cpu
cpu-architecture	tag	cpu-architecture
cpu-cache	tag	cpu-cache
cpython	tag	cpython
cql	tag	cql
crash	tag	crash
create-table	tag	create-table
credentials	tag	credentials
credible-interval	tag	credible-interval
cron	tag	cron
cronbachs-alpha	tag	cronbachs-alpha
cross-apply	tag	cross-apply
cross-browser	tag	cross-browser
cross-correlation	tag	cross-correlation
cross-domain	tag	cross-domain
cross-entropy	tag	cross-entropy
cross-platform	tag	cross-platform
cross-reference	tag	cross-reference
cross-validation	tag	cross-validation
crossover-study	tag	crossover-study
crostons-method	tag	crostons-method
cryptography	tag	cryptography
csh	tag	csh
csrf	tag	csrf
css	tag	css
css-calc	tag	css-calc
css-content	tag	css-content
css-float	tag	css-float
css-hack	tag	css-hack
css-position	tag	css-position
css-selectors	tag	css-selectors
css-shapes	tag	css-shapes
css-transforms	tag	css-transforms
css-transitions	tag	css-transitions
csv	tag	csv
ctags	tag	ctags
cubic	tag	cubic
cuda	tag	cuda
cumulants	tag	cumulants
curl	tag	curl
curly-braces	tag	curly-braces
currency	tag	currency
currying	tag	currying
cursor	tag	cursor
cursor-position	tag	cursor-position
curve-fitting	tag	curve-fitting
curves	tag	curves
custom-data-attribute	tag	custom-data-attribute
custom-exceptions	tag	custom-exceptions
cycle	tag	cycle
cygwin	tag	cygwin
daemon	tag	daemon
dag	tag	dag
dalvik	tag	dalvik
dangling-pointer	tag	dangling-pointer
dao	tag	dao
dashcode	tag	dashcode
data-access-layer	tag	data-access-layer
data-augmentation	tag	data-augmentation
data-binding	tag	data-binding
data-cleaning	tag	data-cleaning
data-conversion	tag	data-conversion
data-imputation	tag	data-imputation
data-manipulation	tag	data-manipulation
data-mining	tag	data-mining
data-modeling	tag	data-modeling
data-preprocessing	tag	data-preprocessing
data-structures	tag	data-structures
data-transformation	tag	data-transformation
data-visualization	tag	data-visualization
data.table	tag	data.table
database	tag	database
database-agnostic	tag	database-agnostic
database-design	tag	database-design
database-indexes	tag	database-indexes
database-schema	tag	database-schema
database-security	tag	database-security
database-sequence	tag	database-sequence
database-table	tag	database-table
dataframe	tag	dataframe
dataset	tag	dataset
datatable	tag	datatable
date	tag	date
date-format	tag	date-format
date-formatting	tag	date-formatting
date-manipulation	tag	date-manipulation
date-parsing	tag	date-parsing
datediff	tag	datediff
datetime	tag	datetime
datetime-format	tag	datetime-format
datetime-parsing	tag	datetime-parsing
datetime2	tag	datetime2
datetimeoffset	tag	datetimeoffset
dbscan	tag	dbscan
dci	tag	dci
ddl	tag	ddl
debugging	tag	debugging
decimal	tag	decimal
decimal-point	tag	decimal-point
decision-theory	tag	decision-theory
declaration	tag	declaration
declarative-programming	tag	declarative-programming
decode	tag	decode
decompiler	tag	decompiler
decompiling	tag	decompiling
decomposition	tag	decomposition
decorator	tag	decorator
decoupling	tag	decoupling
decrement	tag	decrement
deep-belief-networks	tag	deep-belief-networks
deep-copy	tag	deep-copy
deep-learning	tag	deep-learning
default	tag	default
default-method	tag	default-method
default-parameters	tag	default-parameters
default-value	tag	default-value
defaultdict	tag	defaultdict
definition	tag	definition
degrees-of-freedom	tag	degrees-of-freedom
del	tag	del
delay	tag	delay
delegates	tag	delegates
delete-file	tag	delete-file
delete-operator	tag	delete-operator
delimiter	tag	delimiter
delta-method	tag	delta-method
deming-regression	tag	deming-regression
dendrogram	tag	dendrogram
denotational-semantics	tag	denotational-semantics
density-estimation	tag	density-estimation
deobfuscation	tag	deobfuscation
dependencies	tag	dependencies
dependency-injection	tag	dependency-injection
dependency-management	tag	dependency-management
dependent-name	tag	dependent-name
dependent-variable	tag	dependent-variable
deployment	tag	deployment
deprecated	tag	deprecated
der	tag	der
dereference	tag	dereference
derivative	tag	derivative
derived-distributions	tag	derived-distributions
derived-table	tag	derived-table
descriptive-statistics	tag	descriptive-statistics
design-patterns	tag	design-patterns
design-principles	tag	design-principles
destructor	tag	destructor
detection	tag	detection
determinant	tag	determinant
development-environment	tag	development-environment
deviance	tag	deviance
dex	tag	dex
dglm	tag	dglm
dhtml	tag	dhtml
diacritics	tag	diacritics
diagnostic	tag	diagnostic
diagram	tag	diagram
dialog	tag	dialog
dice	tag	dice
dictionary	tag	dictionary
dictionary-comprehension	tag	dictionary-comprehension
die	tag	die
diff	tag	diff
difference	tag	difference
difference-in-difference	tag	difference-in-difference
differential-privacy	tag	differential-privacy
diffmerge	tag	diffmerge
difftool	tag	difftool
digits	tag	digits
dimension	tag	dimension
dimensionality-reduction	tag	dimensionality-reduction
dimensions	tag	dimensions
directory	tag	directory
directory-listing	tag	directory-listing
directory-structure	tag	directory-structure
directory-tree	tag	directory-tree
dirichlet-distribution	tag	dirichlet-distribution
dirichlet-process	tag	dirichlet-process
dirichlet-regression	tag	dirichlet-regression
disabled-input	tag	disabled-input
discrete-data	tag	discrete-data
discriminant-analysis	tag	discriminant-analysis
dispatch	tag	dispatch
dispersion	tag	dispersion
display	tag	display
distance	tag	distance
distance-covariance	tag	distance-covariance
distance-functions	tag	distance-functions
distinct	tag	distinct
distribute	tag	distribute
distribution-identification	tag	distribution-identification
distributions	tag	distributions
distutils	tag	distutils
diversity	tag	diversity
divide	tag	divide
divider	tag	divider
division	tag	division
django	tag	django
django-models	tag	django-models
django-q	tag	django-q
django-queryset	tag	django-queryset
django-views	tag	django-views
dll	tag	dll
dmg	tag	dmg
dml	tag	dml
do-while	tag	do-while
docker	tag	docker
docker-compose	tag	docker-compose
docker-container	tag	docker-container
docker-image	tag	docker-image
docker-networking	tag	docker-networking
dockerfile	tag	dockerfile
docstring	tag	docstring
doctype	tag	doctype
documentation	tag	documentation
dojo-1.8	tag	dojo-1.8
dollar-sign	tag	dollar-sign
dom	tag	dom
dom-events	tag	dom-events
dom-manipulation	tag	dom-manipulation
domain-adaptation	tag	domain-adaptation
dos2unix	tag	dos2unix
dot42	tag	dot42
double	tag	double
download	tag	download
downloadfile	tag	downloadfile
dpi	tag	dpi
dplyr	tag	dplyr
draw	tag	draw
drawable	tag	drawable
drop-down-menu	tag	drop-down-menu
dropbox	tag	dropbox
dropout	tag	dropout
dst	tag	dst
dto	tag	dto
dunn-test	tag	dunn-test
duplicates	tag	duplicates
dvcs	tag	dvcs
dwr	tag	dwr
dyld	tag	dyld
dynamic	tag	dynamic
dynamic-allocation	tag	dynamic-allocation
dynamic-forms	tag	dynamic-forms
dynamic-html	tag	dynamic-html
dynamic-languages	tag	dynamic-languages
dynamic-memory-allocation	tag	dynamic-memory-allocation
dynamic-regression	tag	dynamic-regression
dynamic-typing	tag	dynamic-typing
e-commerce	tag	e-commerce
each	tag	each
easy-install	tag	easy-install
ecdf	tag	ecdf
echo	tag	echo
eclipse	tag	eclipse
eclipse-formatter	tag	eclipse-formatter
eclipse-project-file	tag	eclipse-project-file
ecmascript-2017	tag	ecmascript-2017
ecmascript-5	tag	ecmascript-5
ecmascript-6	tag	ecmascript-6
ecmascript-harmony	tag	ecmascript-harmony
ecology	tag	ecology
econometrics	tag	econometrics
eda	tag	eda
editing	tag	editing
editor	tag	editor
ef-code-first	tag	ef-code-first
ef-database-first	tag	ef-database-first
effect-size	tag	effect-size
effects	tag	effects
efficiency	tag	efficiency
egg	tag	egg
eigenclass	tag	eigenclass
eigenvalues	tag	eigenvalues
elastic-net	tag	elastic-net
elasticsearch	tag	elasticsearch
elasticsearch-dsl	tag	elasticsearch-dsl
elections	tag	elections
element	tag	element
elevated-privileges	tag	elevated-privileges
elicitation	tag	elicitation
ellipsis	tag	ellipsis
elmah	tag	elmah
elo	tag	elo
em	tag	em
emacs	tag	emacs
email	tag	email
email-address	tag	email-address
email-validation	tag	email-validation
embed	tag	embed
embedded	tag	embedded
embedded-fonts	tag	embedded-fonts
embedded-resource	tag	embedded-resource
emma	tag	emma
emoji	tag	emoji
empirical-bayes	tag	empirical-bayes
empirical-likelihood	tag	empirical-likelihood
emulation	tag	emulation
encapsulation	tag	encapsulation
encode	tag	encode
encoding	tag	encoding
encryption	tag	encryption
endogeneity	tag	endogeneity
ends-with	tag	ends-with
ensemble	tag	ensemble
enter	tag	enter
enterprise-integration	tag	enterprise-integration
entity	tag	entity
entity-framework	tag	entity-framework
entity-framework-4	tag	entity-framework-4
entity-framework-4.1	tag	entity-framework-4.1
entity-framework-5	tag	entity-framework-5
entitymanager	tag	entitymanager
entropy	tag	entropy
enumerate	tag	enumerate
enumeration	tag	enumeration
enums	tag	enums
environment-variables	tag	environment-variables
eof	tag	eof
eol	tag	eol
epidemic-curve	tag	epidemic-curve
epidemiology	tag	epidemiology
epoch	tag	epoch
equality	tag	equality
equality-operator	tag	equality-operator
equals	tag	equals
equivalence	tag	equivalence
erase	tag	erase
erlang	tag	erlang
error	tag	error
error-detection	tag	error-detection
error-handling	tag	error-handling
error-message	tag	error-message
error-reporting	tag	error-reporting
error-suppression	tag	error-suppression
errors-in-variables	tag	errors-in-variables
es6-promise	tag	es6-promise
escaping	tag	escaping
eslint	tag	eslint
estimation	tag	estimation
estimators	tag	estimators
etymology	tag	etymology
euclidean	tag	euclidean
euclidean-distance	tag	euclidean-distance
eval	tag	eval
event-bubbling	tag	event-bubbling
event-handling	tag	event-handling
event-loop	tag	event-loop
event-propagation	tag	event-propagation
evented-io	tag	evented-io
events	tag	events
ews-managed-api	tag	ews-managed-api
excel	tag	excel
except	tag	except
exception	tag	exception
exception-handling	tag	exception-handling
exchangeability	tag	exchangeability
exchangewebservices	tag	exchangewebservices
exe	tag	exe
executable	tag	executable
executable-jar	tag	executable-jar
execution	tag	execution
execution-time	tag	execution-time
exit	tag	exit
exit-code	tag	exit-code
expectation-maximization	tag	expectation-maximization
expected-value	tag	expected-value
experiment-design	tag	experiment-design
explanatory-models	tag	explanatory-models
explicit	tag	explicit
explicit-constructor	tag	explicit-constructor
exponential	tag	exponential
exponential-distribution	tag	exponential-distribution
exponential-family	tag	exponential-family
exponential-smoothing	tag	exponential-smoothing
export	tag	export
express	tag	express
expression	tag	expression
expression-trees	tag	expression-trees
extend	tag	extend
extends	tag	extends
extension-methods	tag	extension-methods
extern	tag	extern
extern-c	tag	extern-c
extract	tag	extract
extrapolation	tag	extrapolation
extreme-value	tag	extreme-value
f#	tag	f#
f-distribution	tag	f-distribution
f-statistic	tag	f-statistic
f-string	tag	f-string
f-test	tag	f-test
facebook	tag	facebook
facebook-graph-api	tag	facebook-graph-api
factor-analysis	tag	factor-analysis
factor-rotation	tag	factor-rotation
factory	tag	factory
factory-method	tag	factory-method
factory-pattern	tag	factory-pattern
failed-installation	tag	failed-installation
fallacy	tag	fallacy
false-discovery-rate	tag	false-discovery-rate
false-positive-rate	tag	false-positive-rate
family-tree	tag	family-tree
familywise-error	tag	familywise-error
fast-forward	tag	fast-forward
fast-math	tag	fast-math
fat-tails	tag	fat-tails
fatal-error	tag	fatal-error
fault-tolerance	tag	fault-tolerance
favicon	tag	favicon
feature-branch	tag	feature-branch
feature-engineering	tag	feature-engineering
feature-selection	tag	feature-selection
feof	tag	feof
fetch-api	tag	fetch-api
ffmpeg	tag	ffmpeg
fiducial	tag	fiducial
field	tag	field
file	tag	file
file-copying	tag	file-copying
file-exists	tag	file-exists
file-extension	tag	file-extension
file-handling	tag	file-handling
file-io	tag	file-io
file-locking	tag	file-locking
file-permissions	tag	file-permissions
file-read	tag	file-read
file-rename	tag	file-rename
file-search	tag	file-search
file-upload	tag	file-upload
filenames	tag	filenames
fileserver	tag	fileserver
filesystems	tag	filesystems
filter	tag	filter
final	tag	final
finance	tag	finance
find	tag	find
finder	tag	finder
findviewbyid	tag	findviewbyid
finite-mixture-model	tag	finite-mixture-model
finite-population	tag	finite-population
firebug	tag	firebug
firefox	tag	firefox
fisher-information	tag	fisher-information
fisher-scoring	tag	fisher-scoring
fishers-exact	tag	fishers-exact
fishers-lsd	tag	fishers-lsd
fitting	tag	fitting
fixed	tag	fixed
fixed-effects-model	tag	fixed-effects-model
flags	tag	flags
flash	tag	flash
flash-cs4	tag	flash-cs4
flask	tag	flask
flask-restless	tag	flask-restless
flatten	tag	flatten
flexbox	tag	flexbox
floating-accuracy	tag	floating-accuracy
floating-action-button	tag	floating-action-button
floating-point	tag	floating-point
flops	tag	flops
flush	tag	flush
flux	tag	flux
fnmatch	tag	fnmatch
focus	tag	focus
folding	tag	folding
font-face	tag	font-face
font-size	tag	font-size
fonts	tag	fonts
footer	tag	footer
for-else	tag	for-else
for-loop	tag	for-loop
forced-unwrapping	tag	forced-unwrapping
foreach	tag	foreach
forecast-combination	tag	forecast-combination
forecastability	tag	forecastability
forecasting	tag	forecasting
foreign-keys	tag	foreign-keys
form-data	tag	form-data
form-submit	tag	form-submit
format	tag	format
format-specifiers	tag	format-specifiers
formatting	tag	formatting
forms	tag	forms
forms-authentication	tag	forms-authentication
forward-backward	tag	forward-backward
forward-declaration	tag	forward-declaration
fourier-transform	tag	fourier-transform
fragment-identifier	tag	fragment-identifier
fragmenttransaction	tag	fragmenttransaction
frameworks	tag	frameworks
fraud	tag	fraud
free	tag	free
frequency	tag	frequency
frequentist	tag	frequentist
friendly-url	tag	friendly-url
frontend	tag	frontend
frp	tag	frp
fs	tag	fs
full-outer-join	tag	full-outer-join
full-text-search	tag	full-text-search
fullscreen	tag	fullscreen
func	tag	func
function	tag	function
function-call-operator	tag	function-call-operator
function-composition	tag	function-composition
function-definition	tag	function-definition
function-object	tag	function-object
function-pointers	tag	function-pointers
functional-data-analysis	tag	functional-data-analysis
functional-programming	tag	functional-programming
functools	tag	functools
functor	tag	functor
fused-lasso	tag	fused-lasso
fuzzy	tag	fuzzy
g++	tag	g++
gam	tag	gam
game-theory	tag	game-theory
games	tag	games
gamlss	tag	gamlss
gamma-distribution	tag	gamma-distribution
gan	tag	gan
garbage-collection	tag	garbage-collection
garch	tag	garch
gaussian-mixture	tag	gaussian-mixture
gaussian-process	tag	gaussian-process
gbm	tag	gbm
gcc	tag	gcc
gee	tag	gee
gem	tag	gem
generalized-least-squares	tag	generalized-least-squares
generalized-linear-model	tag	generalized-linear-model
generalized-moments	tag	generalized-moments
generative-models	tag	generative-models
generator	tag	generator
generic-constraints	tag	generic-constraints
generic-list	tag	generic-list
generics	tag	generics
genetic-algorithms	tag	genetic-algorithms
genetics	tag	genetics
genymotion	tag	genymotion
geolocation	tag	geolocation
geometric-distribution	tag	geometric-distribution
geometric-mean	tag	geometric-mean
geometry	tag	geometry
geostatistics	tag	geostatistics
gesture-recognition	tag	gesture-recognition
get	tag	get
getcwd	tag	getcwd
gethashcode	tag	gethashcode
getline	tag	getline
getopts	tag	getopts
getter	tag	getter
getter-setter	tag	getter-setter
gettype	tag	gettype
ggplot2	tag	ggplot2
gibbs	tag	gibbs
gif	tag	gif
gini	tag	gini
gis	tag	gis
gist	tag	gist
git	tag	git
git-add	tag	git-add
git-archive	tag	git-archive
git-bare	tag	git-bare
git-bash	tag	git-bash
git-branch	tag	git-branch
git-checkout	tag	git-checkout
git-cherry-pick	tag	git-cherry-pick
git-clean	tag	git-clean
git-clone	tag	git-clone
git-commands	tag	git-commands
git-commit	tag	git-commit
git-config	tag	git-config
git-diff	tag	git-diff
git-difftool	tag	git-difftool
git-fetch	tag	git-fetch
git-filter-branch	tag	git-filter-branch
git-flow	tag	git-flow
git-fork	tag	git-fork
git-gui	tag	git-gui
git-history-graph	tag	git-history-graph
git-index	tag	git-index
git-init	tag	git-init
git-log	tag	git-log
git-merge	tag	git-merge
git-merge-conflict	tag	git-merge-conflict
git-non-bare-repository	tag	git-non-bare-repository
git-patch	tag	git-patch
git-pull	tag	git-pull
git-push	tag	git-push
git-rebase	tag	git-rebase
git-remote	tag	git-remote
git-reset	tag	git-reset
git-revert	tag	git-revert
git-rewrite-history	tag	git-rewrite-history
git-rm	tag	git-rm
git-show	tag	git-show
git-squash	tag	git-squash
git-stage	tag	git-stage
git-stash	tag	git-stash
git-submodules	tag	git-submodules
git-subtree	tag	git-subtree
git-svn	tag	git-svn
git-tag	tag	git-tag
git-track	tag	git-track
git-workflow	tag	git-workflow
githooks	tag	githooks
github	tag	github
github-flavored-markdown	tag	github-flavored-markdown
gitignore	tag	gitignore
gitlab	tag	gitlab
gitx	tag	gitx
gjslint	tag	gjslint
glmm	tag	glmm
glmnet	tag	glmnet
glob	tag	glob
global	tag	global
global-variables	tag	global-variables
glossary	tag	glossary
gmail	tag	gmail
gmt	tag	gmt
gnu	tag	gnu
gnu-make	tag	gnu-make
gnu-screen	tag	gnu-screen
go	tag	go
go-map	tag	go-map
goodman-kruskal-gamma	tag	goodman-kruskal-gamma
goodness-of-fit	tag	goodness-of-fit
google-ajax-libraries	tag	google-ajax-libraries
google-api	tag	google-api
google-chrome	tag	google-chrome
google-chrome-devtools	tag	google-chrome-devtools
google-chrome-extension	tag	google-chrome-extension
google-maps	tag	google-maps
google-maps-api-3	tag	google-maps-api-3
google-maps-markers	tag	google-maps-markers
google-play	tag	google-play
google-play-services	tag	google-play-services
google-search	tag	google-search
google-sheets	tag	google-sheets
google-sheets-formula	tag	google-sheets-formula
gps	tag	gps
gradient	tag	gradient
gradient-descent	tag	gradient-descent
gradle	tag	gradle
gradle-eclipse	tag	gradle-eclipse
gradle-plugin	tag	gradle-plugin
grails	tag	grails
grand-central-dispatch	tag	grand-central-dispatch
granger-causality	tag	granger-causality
graph	tag	graph
graph-layout	tag	graph-layout
graph-theory	tag	graph-theory
graphical-model	tag	graphical-model
graphics	tag	graphics
grayscale	tag	grayscale
greatest-n-per-group	tag	greatest-n-per-group
grep	tag	grep
groovy	tag	groovy
group-by	tag	group-by
group-concat	tag	group-concat
group-differences	tag	group-differences
groupwise-maximum	tag	groupwise-maximum
growth-model	tag	growth-model
gru	tag	gru
gruntjs	tag	gruntjs
gs-conditional-formatting	tag	gs-conditional-formatting
gson	tag	gson
guid	tag	guid
gulp	tag	gulp
gumbel	tag	gumbel
gwas	tag	gwas
gzip	tag	gzip
hammingweight	tag	hammingweight
handler	tag	handler
hardlink	tag	hardlink
hash	tag	hash
hash-collision	tag	hash-collision
hashbang	tag	hashbang
hashchange	tag	hashchange
hashcode	tag	hashcode
hashmap	tag	hashmap
hashset	tag	hashset
hashtable	tag	hashtable
haskell	tag	haskell
haversine	tag	haversine
haxm	tag	haxm
hazard	tag	hazard
hbm2ddl	tag	hbm2ddl
hdf5	tag	hdf5
head	tag	head
header	tag	header
header-files	tag	header-files
heap	tag	heap
heap-memory	tag	heap-memory
heatmap	tag	heatmap
heavy-tailed	tag	heavy-tailed
heckman	tag	heckman
height	tag	height
hellinger	tag	hellinger
heredoc	tag	heredoc
heroku	tag	heroku
hessian	tag	hessian
heteroscedasticity	tag	heteroscedasticity
hex	tag	hex
hibernate	tag	hibernate
hidden	tag	hidden
hidden-characters	tag	hidden-characters
hidden-features	tag	hidden-features
hidden-markov-model	tag	hidden-markov-model
hide	tag	hide
hierarchical-bayesian	tag	hierarchical-bayesian
hierarchical-clustering	tag	hierarchical-clustering
hierarchical-data	tag	hierarchical-data
hierarchy	tag	hierarchy
high-dimensional	tag	high-dimensional
highest-density-region	tag	highest-density-region
highlight	tag	highlight
hindley-milner	tag	hindley-milner
histogram	tag	histogram
history	tag	history
hmc	tag	hmc
home-directory	tag	home-directory
homebrew	tag	homebrew
hosmer-lemeshow-test	tag	hosmer-lemeshow-test
hostname	tag	hostname
hotkeys	tag	hotkeys
hover	tag	hover
href	tag	href
html	tag	html
html-agility-pack	tag	html-agility-pack
html-encode	tag	html-encode
html-entities	tag	html-entities
html-escape-characters	tag	html-escape-characters
html-head	tag	html-head
html-input	tag	html-input
html-lists	tag	html-lists
html-parsing	tag	html-parsing
html-sanitizing	tag	html-sanitizing
html-select	tag	html-select
html-table	tag	html-table
html5-audio	tag	html5-audio
html5-canvas	tag	html5-canvas
html5-validation	tag	html5-validation
html5boilerplate	tag	html5boilerplate
htmlbutton	tag	htmlbutton
http	tag	http
http-get	tag	http-get
http-headers	tag	http-headers
http-method	tag	http-method
http-post	tag	http-post
http-response-codes	tag	http-response-codes
http-status-code-401	tag	http-status-code-401
http-status-code-403	tag	http-status-code-403
http-status-code-404	tag	http-status-code-404
http-status-codes	tag	http-status-codes
http-token-authentication	tag	http-token-authentication
httpd.conf	tag	httpd.conf
httprequest	tag	httprequest
https	tag	https
httpserver	tag	httpserver
httpurlconnection	tag	httpurlconnection
httpwebrequest	tag	httpwebrequest
hudson	tag	hudson
humor	tag	humor
hyperlink	tag	hyperlink
hyperparameter	tag	hyperparameter
hypothesis-testing	tag	hypothesis-testing
ica	tag	ica
icons	tag	icons
id	tag	id
ide	tag	ide
idempotent	tag	idempotent
identifiability	tag	identifiability
identifying-relationship	tag	identifying-relationship
identity	tag	identity
identity-operator	tag	identity-operator
idiomatic	tag	idiomatic
idioms	tag	idioms
idisposable	tag	idisposable
iec10967	tag	iec10967
ienumerable	tag	ienumerable
if-statement	tag	if-statement
iframe	tag	iframe
ignore	tag	ignore
iid	tag	iid
iidentity	tag	iidentity
iife	tag	iife
iis	tag	iis
iis-10	tag	iis-10
iis-7	tag	iis-7
iis-8.5	tag	iis-8.5
iis-express	tag	iis-express
iis-manager	tag	iis-manager
iis-metabase	tag	iis-metabase
illegalargumentexception	tag	illegalargumentexception
illegalstateexception	tag	illegalstateexception
image	tag	image
image-processing	tag	image-processing
image-resizing	tag	image-resizing
image-scaling	tag	image-scaling
imagebutton	tag	imagebutton
imageview	tag	imageview
imdb	tag	imdb
immutability	tag	immutability
imperative-programming	tag	imperative-programming
implementation-defined-behavior	tag	implementation-defined-behavior
implements	tag	implements
import	tag	import
importance	tag	importance
importance-sampling	tag	importance-sampling
importerror	tag	importerror
improper-prior	tag	improper-prior
imputation	tag	imputation
in-place	tag	in-place
incidence-rate-ratio	tag	incidence-rate-ratio
include	tag	include
incompatibility	tag	incompatibility
increment	tag	increment
indentation	tag	indentation
independence	tag	independence
indexing	tag	indexing
inference	tag	inference
infinite	tag	infinite
infinity	tag	infinity
info.plist	tag	info.plist
information-geometry	tag	information-geometry
information-hiding	tag	information-hiding
information-retrieval	tag	information-retrieval
information-schema	tag	information-schema
information-theory	tag	information-theory
inheritance	tag	inheritance
init	tag	init
initialization	tag	initialization
inject	tag	inject
inline	tag	inline
inline-styles	tag	inline-styles
inner-classes	tag	inner-classes
inner-join	tag	inner-join
innerhtml	tag	innerhtml
innodb	tag	innodb
innovation	tag	innovation
inotify	tag	inotify
inotifypropertychanged	tag	inotifypropertychanged
input	tag	input
input-type-file	tag	input-type-file
inputstream	tag	inputstream
insert	tag	insert
insert-update	tag	insert-update
installation	tag	installation
instance-variables	tag	instance-variables
instanceof	tag	instanceof
instantiation	tag	instantiation
instrumental-variables	tag	instrumental-variables
int	tag	int
integer	tag	integer
integer-arithmetic	tag	integer-arithmetic
integer-division	tag	integer-division
integer-overflow	tag	integer-overflow
integral	tag	integral
integrated-pipeline-mode	tag	integrated-pipeline-mode
intel	tag	intel
intellij-idea	tag	intellij-idea
intellij-inspections	tag	intellij-inspections
interaction	tag	interaction
interactive-visualization	tag	interactive-visualization
interarrival-time	tag	interarrival-time
intercept	tag	intercept
interface	tag	interface
interface-builder	tag	interface-builder
interlocked	tag	interlocked
intermittent-time-series	tag	intermittent-time-series
internals	tag	internals
internet-connection	tag	internet-connection
internet-explorer	tag	internet-explorer
internet-explorer-10	tag	internet-explorer-10
internet-explorer-6	tag	internet-explorer-6
internet-explorer-9	tag	internet-explorer-9
interop	tag	interop
interpolation	tag	interpolation
interpretation	tag	interpretation
interpreted-language	tag	interpreted-language
interquartile	tag	interquartile
intersection	tag	intersection
interval-censoring	tag	interval-censoring
intraclass-correlation	tag	intraclass-correlation
introspection	tag	introspection
intuition	tag	intuition
invalid-characters	tag	invalid-characters
invariance	tag	invariance
inverse-cdf	tag	inverse-cdf
inverse-gaussian-distrib	tag	inverse-gaussian-distrib
inversion-of-control	tag	inversion-of-control
invoke	tag	invoke
io	tag	io
io-redirection	tag	io-redirection
ioc-container	tag	ioc-container
ios	tag	ios
ios-simulator	tag	ios-simulator
ios10	tag	ios10
ios13	tag	ios13
ios6	tag	ios6
ios7	tag	ios7
ios8	tag	ios8
ios9	tag	ios9
iostream	tag	iostream
ip-address	tag	ip-address
ipa	tag	ipa
ipad	tag	ipad
iphone	tag	iphone
iphone-5	tag	iphone-5
iprincipal	tag	iprincipal
ipython	tag	ipython
iqueryable	tag	iqueryable
irls	tag	irls
ironpython	tag	ironpython
irt	tag	irt
is-empty	tag	is-empty
isnumeric	tag	isnumeric
iso8601	tag	iso8601
isolated-scope	tag	isolated-scope
isset	tag	isset
issue-tracking	tag	issue-tracking
items	tag	items
iterable	tag	iterable
iterable-unpacking	tag	iterable-unpacking
iteration	tag	iteration
iterator	tag	iterator
itertools	tag	itertools
j#	tag	j#
jackknife	tag	jackknife
jackson	tag	jackson
jacobian	tag	jacobian
jags	tag	jags
jakarta-ee	tag	jakarta-ee
jar	tag	jar
jasmine	tag	jasmine
java	tag	java
java-10	tag	java-10
java-11	tag	java-11
java-6	tag	java-6
java-7	tag	java-7
java-8	tag	java-8
java-9	tag	java-9
java-io	tag	java-io
java-native-interface	tag	java-native-interface
java-persistence-api	tag	java-persistence-api
java-stream	tag	java-stream
java-threads	tag	java-threads
java-time	tag	java-time
java.util.scanner	tag	java.util.scanner
javabeans	tag	javabeans
javac	tag	javac
javadoc	tag	javadoc
javamail	tag	javamail
javascript	tag	javascript
javascript-events	tag	javascript-events
javascript-framework	tag	javascript-framework
javascript-namespaces	tag	javascript-namespaces
javascript-objects	tag	javascript-objects
javascriptserializer	tag	javascriptserializer
jaxb	tag	jaxb
jdbc	tag	jdbc
jdk1.5	tag	jdk1.5
jdk6	tag	jdk6
jeffreys-prior	tag	jeffreys-prior
jenkins	tag	jenkins
jersey	tag	jersey
jetbrains-ide	tag	jetbrains-ide
jframe	tag	jframe
jit	tag	jit
jmp	tag	jmp
jms	tag	jms
join	tag	join
joint-distribution	tag	joint-distribution
journals	tag	journals
jpa	tag	jpa
jpeg	tag	jpeg
jpype	tag	jpype
jquery	tag	jquery
jquery-append	tag	jquery-append
jquery-events	tag	jquery-events
jquery-on	tag	jquery-on
jquery-plugins	tag	jquery-plugins
jquery-selectors	tag	jquery-selectors
jquery-ui	tag	jquery-ui
jquery-ui-datepicker	tag	jquery-ui-datepicker
jquery-ui-dialog	tag	jquery-ui-dialog
jsf	tag	jsf
jshint	tag	jshint
jslint	tag	jslint
json	tag	json
json.net	tag	json.net
jsonp	tag	jsonp
jsp	tag	jsp
julia	tag	julia
junit	tag	junit
junit4	tag	junit4
jupyter-notebook	tag	jupyter-notebook
jvm	tag	jvm
jvm-hotspot	tag	jvm-hotspot
jwt	tag	jwt
jython	tag	jython
k-means	tag	k-means
k-nearest-neighbour	tag	k-nearest-neighbour
kaggle	tag	kaggle
kalman-filter	tag	kalman-filter
kaplan-meier	tag	kaplan-meier
kendall-tau	tag	kendall-tau
keras	tag	keras
kernel	tag	kernel
kernel-smoothing	tag	kernel-smoothing
kernel-trick	tag	kernel-trick
key	tag	key
keyboard	tag	keyboard
keyboard-events	tag	keyboard-events
keyboard-input	tag	keyboard-input
keyboard-shortcuts	tag	keyboard-shortcuts
keyevent	tag	keyevent
keylistener	tag	keylistener
keypress	tag	keypress
keystore	tag	keystore
keyword	tag	keyword
keyword-search	tag	keyword-search
kill	tag	kill
kill-process	tag	kill-process
kolmogorov-axioms	tag	kolmogorov-axioms
kolmogorov-smirnov	tag	kolmogorov-smirnov
kotlin	tag	kotlin
kpss-test	tag	kpss-test
kriging	tag	kriging
kruskal-wallis	tag	kruskal-wallis
ksh	tag	ksh
kullback-leibler	tag	kullback-leibler
kurtosis	tag	kurtosis
kvm	tag	kvm
kwargs	tag	kwargs
l-moments	tag	l-moments
label	tag	label
labels	tag	labels
lagrange-multipliers	tag	lagrange-multipliers
lags	tag	lags
lambda	tag	lambda
lambda-calculus	tag	lambda-calculus
language-agnostic	tag	language-agnostic
language-comparisons	tag	language-comparisons
language-design	tag	language-design
language-features	tag	language-features
language-lawyer	tag	language-lawyer
language-models	tag	language-models
laplace-distribution	tag	laplace-distribution
laplace-smoothing	tag	laplace-smoothing
lapply	tag	lapply
laravel	tag	laravel
laravel-4	tag	laravel-4
laravel-query-builder	tag	laravel-query-builder
large-data	tag	large-data
large-files	tag	large-files
large-scale	tag	large-scale
lars	tag	lars
lasso	tag	lasso
late-static-binding	tag	late-static-binding
latent-class	tag	latent-class
latent-dirichlet-alloc	tag	latent-dirichlet-alloc
latent-variable	tag	latent-variable
latex	tag	latex
latitude-longitude	tag	latitude-longitude
law-of-large-numbers	tag	law-of-large-numbers
layout	tag	layout
lazy-evaluation	tag	lazy-evaluation
ldap	tag	ldap
ldap-query	tag	ldap-query
least-absolute-deviations	tag	least-absolute-deviations
least-astonishment	tag	least-astonishment
least-squares	tag	least-squares
left-join	tag	left-join
legend	tag	legend
let	tag	let
letter	tag	letter
leverage	tag	leverage
lexical-scope	tag	lexical-scope
libjpeg	tag	libjpeg
libraries	tag	libraries
libsvm	tag	libsvm
licensing	tag	licensing
likelihood	tag	likelihood
likelihood-principle	tag	likelihood-principle
likelihood-ratio	tag	likelihood-ratio
likert	tag	likert
lime	tag	lime
limit	tag	limit
line-breaks	tag	line-breaks
line-count	tag	line-count
line-intersection	tag	line-intersection
linear	tag	linear
linear-algebra	tag	linear-algebra
linear-model	tag	linear-model
linearity	tag	linearity
linefeed	tag	linefeed
lines	tag	lines
lines-of-code	tag	lines-of-code
link-function	tag	link-function
linkage	tag	linkage
linked-list	tag	linked-list
linker	tag	linker
linker-errors	tag	linker-errors
linq	tag	linq
linq-to-objects	tag	linq-to-objects
linq-to-sql	tag	linq-to-sql
linq-to-xml	tag	linq-to-xml
lint	tag	lint
linux	tag	linux
linux-containers	tag	linux-containers
linux-kernel	tag	linux-kernel
liskov-substitution-principle	tag	liskov-substitution-principle
list	tag	list
list-comprehension	tag	list-comprehension
list-manipulation	tag	list-manipulation
listen	tag	listen
listener	tag	listener
listview	tag	listview
literals	tag	literals
llvm	tag	llvm
llvm-codegen	tag	llvm-codegen
lm	tag	lm
lme4-nlme	tag	lme4-nlme
local-storage	tag	local-storage
local-variables	tag	local-variables
locale	tag	locale
localhost	tag	localhost
localization	tag	localization
location	tag	location
lockfile	tag	lockfile
locking	tag	locking
lodash	tag	lodash
loess	tag	loess
log-likelihood	tag	log-likelihood
log-linear	tag	log-linear
log-loss	tag	log-loss
logarithm	tag	logarithm
logging	tag	logging
logic	tag	logic
logical-operators	tag	logical-operators
logistic	tag	logistic
logistic-curve	tag	logistic-curve
logistic-distribution	tag	logistic-distribution
logit	tag	logit
lognormal	tag	lognormal
logrotate	tag	logrotate
long-integer	tag	long-integer
long-lines	tag	long-lines
long-polling	tag	long-polling
lookahead	tag	lookahead
lookup	tag	lookup
loopback-address	tag	loopback-address
loops	tag	loops
loss-functions	tag	loss-functions
lowercase	tag	lowercase
ls	tag	ls
lsa	tag	lsa
lsmeans	tag	lsmeans
lstm	tag	lstm
lucene	tag	lucene
m2eclipse	tag	m2eclipse
machine-learning	tag	machine-learning
macos	tag	macos
macos-high-sierra	tag	macos-high-sierra
macos-sierra	tag	macos-sierra
macros	tag	macros
macvim	tag	macvim
mad	tag	mad
mae	tag	mae
magic-methods	tag	magic-methods
magic-numbers	tag	magic-numbers
mailto	tag	mailto
main	tag	main
makefile	tag	makefile
malloc	tag	malloc
man-in-the-middle	tag	man-in-the-middle
manifest	tag	manifest
manifold-learning	tag	manifold-learning
manipulation-detection	tag	manipulation-detection
manova	tag	manova
manpage	tag	manpage
manual-retain-release	tag	manual-retain-release
manualresetevent	tag	manualresetevent
many-categories	tag	many-categories
map	tag	map
map-function	tag	map-function
mape	tag	mape
mapping	tag	mapping
maps	tag	maps
margin	tag	margin
marginal	tag	marginal
mariadb	tag	mariadb
markdown	tag	markdown
marketing	tag	marketing
markov-process	tag	markov-process
markov-random-field	tag	markov-random-field
mars	tag	mars
marshalling	tag	marshalling
martingale	tag	martingale
mase	tag	mase
match	tag	match
matching	tag	matching
material-design	tag	material-design
math	tag	math
mathematica	tag	mathematica
mathematical-expressions	tag	mathematical-expressions
mathematical-statistics	tag	mathematical-statistics
matlab	tag	matlab
matplotlib	tag	matplotlib
matrix	tag	matrix
matrix-calculus	tag	matrix-calculus
matrix-decomposition	tag	matrix-decomposition
matrix-inverse	tag	matrix-inverse
maven	tag	maven
maven-2	tag	maven-2
maven-3	tag	maven-3
maven-metadata	tag	maven-metadata
max	tag	max
max-margin	tag	max-margin
maximum	tag	maximum
maximum-entropy	tag	maximum-entropy
maximum-likelihood	tag	maximum-likelihood
maxlength	tag	maxlength
mbunit	tag	mbunit
mcmc	tag	mcmc
mcnemar-test	tag	mcnemar-test
md5	tag	md5
mean	tag	mean
measure	tag	measure
measure-theory	tag	measure-theory
measurement	tag	measurement
measurement-error	tag	measurement-error
media-queries	tag	media-queries
median	tag	median
mediation	tag	mediation
medicine	tag	medicine
memcached	tag	memcached
memory	tag	memory
memory-leaks	tag	memory-leaks
memory-limit	tag	memory-limit
memory-management	tag	memory-management
memory-model	tag	memory-model
memorystream	tag	memorystream
menuitem	tag	menuitem
mercurial	tag	mercurial
merge	tag	merge
merge-conflict-resolution	tag	merge-conflict-resolution
message-queue	tag	message-queue
messages	tag	messages
meta	tag	meta
meta-analysis	tag	meta-analysis
meta-regression	tag	meta-regression
meta-tags	tag	meta-tags
metaclass	tag	metaclass
metadata	tag	metadata
metasyntactic-variable	tag	metasyntactic-variable
method-of-moments	tag	method-of-moments
methodology	tag	methodology
methods	tag	methods
metric	tag	metric
metropolis-hastings	tag	metropolis-hastings
mgcv	tag	mgcv
mgf	tag	mgf
microarray	tag	microarray
microbenchmark	tag	microbenchmark
middleware	tag	middleware
midi	tag	midi
migration	tag	migration
mime	tag	mime
mime-types	tag	mime-types
mingw	tag	mingw
minimum	tag	minimum
mipmaps	tag	mipmaps
missing-data	tag	missing-data
misspecification	tag	misspecification
mixed-model	tag	mixed-model
mixed-type-data	tag	mixed-type-data
mixins	tag	mixins
mixture	tag	mixture
mkdir	tag	mkdir
mobile	tag	mobile
mobile-browser	tag	mobile-browser
mobile-phones	tag	mobile-phones
mobile-safari	tag	mobile-safari
mocking	tag	mocking
mockito	tag	mockito
mod-rewrite	tag	mod-rewrite
modal-dialog	tag	modal-dialog
modalviewcontroller	tag	modalviewcontroller
mode	tag	mode
model	tag	model
model-averaging	tag	model-averaging
model-comparison	tag	model-comparison
model-evaluation	tag	model-evaluation
model-selection	tag	model-selection
model-view-controller	tag	model-view-controller
modeling	tag	modeling
modernizr	tag	modernizr
modularity	tag	modularity
module	tag	module
modulo	tag	modulo
momentjs	tag	momentjs
moments	tag	moments
monads	tag	monads
mongo-shell	tag	mongo-shell
mongodb	tag	mongodb
mongodb-query	tag	mongodb-query
mongoose	tag	mongoose
mongrel	tag	mongrel
monitoring	tag	monitoring
monkeypatching	tag	monkeypatching
mono	tag	mono
monoids	tag	monoids
monte-carlo	tag	monte-carlo
mount	tag	mount
mouse-position	tag	mouse-position
mouseclick-event	tag	mouseclick-event
move-semantics	tag	move-semantics
moving-average	tag	moving-average
ms-office	tag	ms-office
ms-word	tag	ms-word
msbuild	tag	msbuild
mse	tag	mse
mstest	tag	mstest
msysgit	tag	msysgit
multi-catch	tag	multi-catch
multi-class	tag	multi-class
multi-index	tag	multi-index
multiarmed-bandit	tag	multiarmed-bandit
multicollinearity	tag	multicollinearity
multicore	tag	multicore
multidimensional-array	tag	multidimensional-array
multidimensional-scaling	tag	multidimensional-scaling
multilabel	tag	multilabel
multilevel-analysis	tag	multilevel-analysis
multiline	tag	multiline
multilinestring	tag	multilinestring
multimarkdown	tag	multimarkdown
multinomial	tag	multinomial
multipartform-data	tag	multipartform-data
multiple-columns	tag	multiple-columns
multiple-comparisons	tag	multiple-comparisons
multiple-imputation	tag	multiple-imputation
multiple-inheritance	tag	multiple-inheritance
multiple-regression	tag	multiple-regression
multiple-seasonalities	tag	multiple-seasonalities
multiple-variable-return	tag	multiple-variable-return
multiplication	tag	multiplication
multiprocessing	tag	multiprocessing
multithreading	tag	multithreading
multivariable	tag	multivariable
multivariate-analysis	tag	multivariate-analysis
multivariate-distribution	tag	multivariate-distribution
multivariate-normal	tag	multivariate-normal
multivariate-regression	tag	multivariate-regression
mutable	tag	mutable
mutex	tag	mutex
mutual-information	tag	mutual-information
mv	tag	mv
mvn-repo	tag	mvn-repo
mvp	tag	mvp
mvvm	tag	mvvm
myisam	tag	myisam
mysql	tag	mysql
mysql-error-1071	tag	mysql-error-1071
mysql-error-1093	tag	mysql-error-1093
mysql-error-1130	tag	mysql-error-1130
mysql-error-1142	tag	mysql-error-1142
mysql-python	tag	mysql-python
mysql-udf	tag	mysql-udf
mysql-workbench	tag	mysql-workbench
mysql2	tag	mysql2
mysql5	tag	mysql5
mysqldump	tag	mysqldump
na	tag	na
naive-bayes	tag	naive-bayes
naivebayes	tag	naivebayes
name-attribute	tag	name-attribute
name-mangling	tag	name-mangling
namedtuple	tag	namedtuple
namespaces	tag	namespaces
naming	tag	naming
naming-conventions	tag	naming-conventions
nan	tag	nan
natural-language	tag	natural-language
navbar	tag	navbar
navigation	tag	navigation
negative-binomial	tag	negative-binomial
nested	tag	nested
nested-data	tag	nested-data
nested-lists	tag	nested-lists
nested-loops	tag	nested-loops
nested-models	tag	nested-models
netstat	tag	netstat
networking	tag	networking
networkonmainthread	tag	networkonmainthread
networks	tag	networks
neural-network	tag	neural-network
neural-networks	tag	neural-networks
neuroimaging	tag	neuroimaging
neuroscience	tag	neuroscience
new-operator	tag	new-operator
new-style-class	tag	new-style-class
newline	tag	newline
ng-bind	tag	ng-bind
ng-class	tag	ng-class
ng-controller	tag	ng-controller
ngfor	tag	ngfor
nginx	tag	nginx
ngoninit	tag	ngoninit
ngroute	tag	ngroute
nls	tag	nls
nnet	tag	nnet
nnmf	tag	nnmf
no-www	tag	no-www
noborder	tag	noborder
noclassdeffounderror	tag	noclassdeffounderror
node-cluster	tag	node-cluster
node-modules	tag	node-modules
node.js	tag	node.js
noexcept	tag	noexcept
nohup	tag	nohup
noise	tag	noise
nolock	tag	nolock
non-clustered-index	tag	non-clustered-index
non-greedy	tag	non-greedy
non-independent	tag	non-independent
nonatomic	tag	nonatomic
nonblocking	tag	nonblocking
nonetype	tag	nonetype
nonlinear	tag	nonlinear
nonlinear-regression	tag	nonlinear-regression
nonparametric	tag	nonparametric
nonparametric-bayes	tag	nonparametric-bayes
normal-approximation	tag	normal-approximation
normal-distribution	tag	normal-distribution
normality-assumption	tag	normality-assumption
normalization	tag	normalization
normalize-css	tag	normalize-css
nosql	tag	nosql
notation	tag	notation
notepad++	tag	notepad++
notin	tag	notin
novelty-detection	tag	novelty-detection
np	tag	np
np-complete	tag	np-complete
np-hard	tag	np-hard
npm	tag	npm
npm-install	tag	npm-install
npm-update	tag	npm-update
nps	tag	nps
npx	tag	npx
nsautolayout	tag	nsautolayout
nsdata	tag	nsdata
nsmutablearray	tag	nsmutablearray
nsnotificationcenter	tag	nsnotificationcenter
nsnumber	tag	nsnumber
nsstring	tag	nsstring
nstimer	tag	nstimer
nsurlconnection	tag	nsurlconnection
nsurlsession	tag	nsurlsession
nuget	tag	nuget
null	tag	null
null-coalescing	tag	null-coalescing
null-coalescing-operator	tag	null-coalescing-operator
nullable	tag	nullable
nullpointerexception	tag	nullpointerexception
nullptr	tag	nullptr
nullreferenceexception	tag	nullreferenceexception
number-formatting	tag	number-formatting
numbers	tag	numbers
numeric	tag	numeric
numerical-integration	tag	numerical-integration
numerics	tag	numerics
numpy	tag	numpy
numpy-ndarray	tag	numpy-ndarray
nvarchar	tag	nvarchar
nvm	tag	nvm
oauth	tag	oauth
oauth-2.0	tag	oauth-2.0
obfuscation	tag	obfuscation
object	tag	object
object-comparison	tag	object-comparison
object-detection	tag	object-detection
object-literal	tag	object-literal
object-property	tag	object-property
object-slicing	tag	object-slicing
objective-c	tag	objective-c
objective-c-blocks	tag	objective-c-blocks
observable	tag	observable
observational-study	tag	observational-study
obsolete	tag	obsolete
odds	tag	odds
odds-ratio	tag	odds-ratio
offset	tag	offset
ofstream	tag	ofstream
omitted-variable-bias	tag	omitted-variable-bias
on-clause	tag	on-clause
onclick	tag	onclick
onclicklistener	tag	onclicklistener
one-definition-rule	tag	one-definition-rule
one-to-many	tag	one-to-many
online	tag	online
ooad	tag	ooad
oop	tag	oop
opacity	tag	opacity
open-source	tag	open-source
opencv	tag	opencv
openid	tag	openid
openssh	tag	openssh
openssl	tag	openssl
operating-system	tag	operating-system
operator-overloading	tag	operator-overloading
operator-precedence	tag	operator-precedence
operators	tag	operators
optimal-stopping	tag	optimal-stopping
optimistic-locking	tag	optimistic-locking
optimization	tag	optimization
option	tag	option
optional	tag	optional
optional-parameters	tag	optional-parameters
options	tag	options
optunity	tag	optunity
oracle	tag	oracle
order-statistics	tag	order-statistics
ordered-logit	tag	ordered-logit
ordinal	tag	ordinal
ordinal-data	tag	ordinal-data
organization	tag	organization
orm	tag	orm
os-detection	tag	os-detection
osdev	tag	osdev
osx-elcapitan	tag	osx-elcapitan
osx-lion	tag	osx-lion
out	tag	out
out-of-memory	tag	out-of-memory
out-of-sample	tag	out-of-sample
outer-join	tag	outer-join
outliers	tag	outliers
output	tag	output
output-formatting	tag	output-formatting
overdispersion	tag	overdispersion
overfitting	tag	overfitting
overflow	tag	overflow
overlay	tag	overlay
overloading	tag	overloading
overriding	tag	overriding
oversampling	tag	oversampling
overwrite	tag	overwrite
p-value	tag	p-value
pac-learning	tag	pac-learning
package	tag	package
package-lock.json	tag	package-lock.json
package-managers	tag	package-managers
package.json	tag	package.json
packages	tag	packages
packaging	tag	packaging
pad	tag	pad
padding	tag	padding
pageload	tag	pageload
pagination	tag	pagination
paired-comparisons	tag	paired-comparisons
paired-data	tag	paired-data
pandas	tag	pandas
pandas-groupby	tag	pandas-groupby
panel-data	tag	panel-data
paradigms	tag	paradigms
paradox	tag	paradox
parallel-computing	tag	parallel-computing
parallel-processing	tag	parallel-processing
parameter-passing	tag	parameter-passing
parameterization	tag	parameterization
parameters	tag	parameters
parametric	tag	parametric
pareto	tag	pareto
pareto-distribution	tag	pareto-distribution
parseint	tag	parseint
parsing	tag	parsing
partial-correlation	tag	partial-correlation
partial-least-squares	tag	partial-least-squares
partial-moments	tag	partial-moments
partial-plot	tag	partial-plot
partial-views	tag	partial-views
particle-filter	tag	particle-filter
partitioning	tag	partitioning
pass-by-reference	tag	pass-by-reference
pass-by-value	tag	pass-by-value
passenger	tag	passenger
passphrase	tag	passphrase
password-encryption	tag	password-encryption
password-protection	tag	password-protection
password-storage	tag	password-storage
passwords	tag	passwords
patch	tag	patch
path	tag	path
path-model	tag	path-model
path-separator	tag	path-separator
path-variables	tag	path-variables
pattern-recognition	tag	pattern-recognition
pca	tag	pca
pcoa	tag	pcoa
pdf	tag	pdf
pdf-generation	tag	pdf-generation
pdo	tag	pdo
pearson-r	tag	pearson-r
pecs	tag	pecs
pem	tag	pem
penalized	tag	penalized
pep8	tag	pep8
percentage	tag	percentage
perceptron	tag	perceptron
perfect-forwarding	tag	perfect-forwarding
perfect-square	tag	perfect-square
performance	tag	performance
performance-testing	tag	performance-testing
perl	tag	perl
permgen	tag	permgen
permission-denied	tag	permission-denied
permissions	tag	permissions
permutation	tag	permutation
permutation-test	tag	permutation-test
perplexity	tag	perplexity
persist	tag	persist
pessimistic-locking	tag	pessimistic-locking
pg	tag	pg
phd	tag	phd
philosophical	tag	philosophical
phone-call	tag	phone-call
phone-number	tag	phone-number
phony-target	tag	phony-target
php	tag	php
php-ini	tag	php-ini
php-internals	tag	php-internals
php-shorttags	tag	php-shorttags
phpmyadmin	tag	phpmyadmin
phpstorm	tag	phpstorm
physics	tag	physics
pi	tag	pi
picocli	tag	picocli
pie-chart	tag	pie-chart
pip	tag	pip
pipe	tag	pipe
pixel	tag	pixel
placeholder	tag	placeholder
platform-agnostic	tag	platform-agnostic
platform-detection	tag	platform-detection
platform-specific	tag	platform-specific
plm	tag	plm
plot	tag	plot
plugins	tag	plugins
png	tag	png
poco	tag	poco
podcast	tag	podcast
point-estimation	tag	point-estimation
point-in-polygon	tag	point-in-polygon
point-process	tag	point-process
pointer-arithmetic	tag	pointer-arithmetic
pointers	tag	pointers
poisson-binomial	tag	poisson-binomial
poisson-distribution	tag	poisson-distribution
poisson-process	tag	poisson-process
poisson-regression	tag	poisson-regression
pojo	tag	pojo
politics	tag	politics
polling	tag	polling
polr	tag	polr
polygon	tag	polygon
polymer	tag	polymer
polymorphism	tag	polymorphism
polynomial	tag	polynomial
pom.xml	tag	pom.xml
pooling	tag	pooling
population	tag	population
population-attributable-fraction	tag	population-attributable-fraction
port	tag	port
portability	tag	portability
position	tag	position
posix	tag	posix
post	tag	post
post-hoc	tag	post-hoc
post-increment	tag	post-increment
posterior	tag	posterior
postgresql	tag	postgresql
postgresql-9.1	tag	postgresql-9.1
postgresql-copy	tag	postgresql-copy
power	tag	power
power-analysis	tag	power-analysis
power-law	tag	power-law
powerpoint	tag	powerpoint
powershell	tag	powershell
powershell-2.0	tag	powershell-2.0
pre-commit	tag	pre-commit
pre-increment	tag	pre-increment
pre-training	tag	pre-training
precision	tag	precision
precision-recall	tag	precision-recall
prediction	tag	prediction
prediction-interval	tag	prediction-interval
predictive-models	tag	predictive-models
predictor	tag	predictor
preflight	tag	preflight
prepared-statement	tag	prepared-statement
prepend	tag	prepend
preprocessor	tag	preprocessor
preprocessor-directive	tag	preprocessor-directive
presentation	tag	presentation
pretty-print	tag	pretty-print
preventdefault	tag	preventdefault
primary-key	tag	primary-key
primitive-types	tag	primitive-types
print-preview	tag	print-preview
printf	tag	printf
printing	tag	printing
prior	tag	prior
private	tag	private
private-methods	tag	private-methods
probabilistic-programming	tag	probabilistic-programming
probability	tag	probability
probability-generating-fn	tag	probability-generating-fn
probability-inequalities	tag	probability-inequalities
probit	tag	probit
process	tag	process
procrustes-analysis	tag	procrustes-analysis
profile	tag	profile
profile-likelihood	tag	profile-likelihood
profiling	tag	profiling
programmatically-created	tag	programmatically-created
programming-languages	tag	programming-languages
proguard	tag	proguard
project-management	tag	project-management
project-structure	tag	project-structure
projection	tag	projection
projects-and-solutions	tag	projects-and-solutions
promise	tag	promise
prompt	tag	prompt
proof	tag	proof
prop	tag	prop
propensity-scores	tag	propensity-scores
properties	tag	properties
proportion	tag	proportion
protected	tag	protected
protection	tag	protection
prototypal-inheritance	tag	prototypal-inheritance
prototype	tag	prototype
prototype-oriented	tag	prototype-oriented
prototype-programming	tag	prototype-programming
prototypejs	tag	prototypejs
provisioning-profile	tag	provisioning-profile
proxy	tag	proxy
pruning	tag	pruning
pseudo-element	tag	pseudo-element
psql	tag	psql
psychology	tag	psychology
psychometrics	tag	psychometrics
psycopg2	tag	psycopg2
public	tag	public
public-key	tag	public-key
publication-bias	tag	publication-bias
pull	tag	pull
pull-request	tag	pull-request
punctuation	tag	punctuation
pure-virtual	tag	pure-virtual
push	tag	push
put	tag	put
putty	tag	putty
puzzle	tag	puzzle
pyc	tag	pyc
pyenv	tag	pyenv
pymc	tag	pymc
pypi	tag	pypi
pypy	tag	pypy
python	tag	python
python-2.5	tag	python-2.5
python-2.7	tag	python-2.7
python-2.x	tag	python-2.x
python-3.6	tag	python-3.6
python-3.x	tag	python-3.x
python-c-api	tag	python-c-api
python-datamodel	tag	python-datamodel
python-decorators	tag	python-decorators
python-import	tag	python-import
python-internals	tag	python-internals
python-module	tag	python-module
python-multithreading	tag	python-multithreading
python-packaging	tag	python-packaging
python-requests	tag	python-requests
python-unicode	tag	python-unicode
python-venv	tag	python-venv
python-wheel	tag	python-wheel
pytz	tag	pytz
q	tag	q
q-learning	tag	q-learning
qemu	tag	qemu
qq-plot	tag	qq-plot
quality-control	tag	quality-control
quantile-regression	tag	quantile-regression
quantiles	tag	quantiles
quasi-likelihood	tag	quasi-likelihood
quasi-maximum-likelihood	tag	quasi-maximum-likelihood
quasi-monte-carlo	tag	quasi-monte-carlo
query-string	tag	query-string
querystringparameter	tag	querystringparameter
queue	tag	queue
queueing	tag	queueing
quotation	tag	quotation
quotes	tag	quotes
quoting	tag	quoting
r	tag	r
r-factor	tag	r-factor
r-faq	tag	r-faq
r-squared	tag	r-squared
r.java-file	tag	r.java-file
rabbitmq	tag	rabbitmq
race-condition	tag	race-condition
rackspace	tag	rackspace
radio-button	tag	radio-button
radix	tag	radix
rails-migrations	tag	rails-migrations
rails-postgresql	tag	rails-postgresql
raise	tag	raise
rake	tag	rake
ram	tag	ram
random	tag	random
random-allocation	tag	random-allocation
random-effects-model	tag	random-effects-model
random-forest	tag	random-forest
random-generation	tag	random-generation
random-matrix	tag	random-matrix
random-variable	tag	random-variable
random-walk	tag	random-walk
randomness	tag	randomness
range	tag	range
ranking	tag	ranking
ranks	tag	ranks
rare-events	tag	rare-events
rating	tag	rating
ratio	tag	ratio
raw-types	tag	raw-types
rawstring	tag	rawstring
razor	tag	razor
rbm	tag	rbm
reachability	tag	reachability
react-jsx	tag	react-jsx
react-native	tag	react-native
react-redux	tag	react-redux
react-router	tag	react-router
reactive-programming	tag	reactive-programming
reactjs	tag	reactjs
reactjs-flux	tag	reactjs-flux
readlines	tag	readlines
readme	tag	readme
readonly	tag	readonly
real-time	tag	real-time
rebase	tag	rebase
recommender-system	tag	recommender-system
record	tag	record
recovery	tag	recovery
recurrent-events	tag	recurrent-events
recursion	tag	recursion
redirect	tag	redirect
redirecttoaction	tag	redirecttoaction
redis	tag	redis
redis-cli	tag	redis-cli
redis-commands	tag	redis-commands
redo	tag	redo
reduce	tag	reduce
reduced-rank-regression	tag	reduced-rank-regression
redux	tag	redux
redux-saga	tag	redux-saga
redux-thunk	tag	redux-thunk
ref	tag	ref
referee	tag	referee
reference	tag	reference
reference-type	tag	reference-type
referenceerror	tag	referenceerror
references	tag	references
reflection	tag	reflection
reformat	tag	reformat
refresh	tag	refresh
refresh-token	tag	refresh-token
regex	tag	regex
regex-greedy	tag	regex-greedy
regex-group	tag	regex-group
regex-negation	tag	regex-negation
registry	tag	registry
regression	tag	regression
regression-coefficients	tag	regression-coefficients
regression-strategies	tag	regression-strategies
regression-to-the-mean	tag	regression-to-the-mean
regularization	tag	regularization
reinforcement-learning	tag	reinforcement-learning
relational-database	tag	relational-database
relational-operators	tag	relational-operators
relative-distribution	tag	relative-distribution
relative-path	tag	relative-path
relative-risk	tag	relative-risk
relative-time-span	tag	relative-time-span
relativesource	tag	relativesource
release	tag	release
reliability	tag	reliability
reload	tag	reload
remember-me	tag	remember-me
reml	tag	reml
remote-branch	tag	remote-branch
remote-execution	tag	remote-execution
remote-server	tag	remote-server
removing-whitespace	tag	removing-whitespace
rename	tag	rename
renderaction	tag	renderaction
rendering	tag	rendering
renderpartial	tag	renderpartial
repeat	tag	repeat
repeatability	tag	repeatability
repeated-measures	tag	repeated-measures
replace	tag	replace
replicability	tag	replicability
replicate	tag	replicate
reporting	tag	reporting
repository	tag	repository
repr	tag	repr
reproducible-research	tag	reproducible-research
request	tag	request
request.form	tag	request.form
require	tag	require
require-once	tag	require-once
requirejs	tag	requirejs
resampling	tag	resampling
reserved-words	tag	reserved-words
reset	tag	reset
resharper	tag	resharper
resharper-7.1	tag	resharper-7.1
residuals	tag	residuals
resolution	tag	resolution
resources	tag	resources
response	tag	response
responsive-design	tag	responsive-design
rest	tag	rest
rest-security	tag	rest-security
restart	tag	restart
restful-authentication	tag	restful-authentication
restful-url	tag	restful-url
restore	tag	restore
retrofit	tag	retrofit
return	tag	return
return-type	tag	return-type
return-value	tag	return-value
reverse	tag	reverse
reverse-engineering	tag	reverse-engineering
reverse-proxy	tag	reverse-proxy
revert	tag	revert
revision	tag	revision
revision-history	tag	revision-history
rfc3339	tag	rfc3339
rfc3986	tag	rfc3986
rgb	tag	rgb
ridge-regression	tag	ridge-regression
right-click	tag	right-click
risk	tag	risk
risk-analysis	tag	risk-analysis
rlm	tag	rlm
rms	tag	rms
rnn	tag	rnn
robust	tag	robust
robust-standard-error	tag	robust-standard-error
roc	tag	roc
roles	tag	roles
rollback	tag	rollback
ronald-fisher	tag	ronald-fisher
roslyn	tag	roslyn
rotation	tag	rotation
rounded-corners	tag	rounded-corners
rounding	tag	rounding
routing	tag	routing
row	tag	row
row-height	tag	row-height
rows	tag	rows
rpart	tag	rpart
rpc	tag	rpc
rsa	tag	rsa
rss	tag	rss
ruby	tag	ruby
ruby-hash	tag	ruby-hash
ruby-on-rails	tag	ruby-on-rails
ruby-on-rails-3	tag	ruby-on-rails-3
ruby-on-rails-4	tag	ruby-on-rails-4
rubygems	tag	rubygems
rule-of-three	tag	rule-of-three
rule-of-thumb	tag	rule-of-thumb
runnable	tag	runnable
runtime-error	tag	runtime-error
runtimeexception	tag	runtimeexception
rvalue-reference	tag	rvalue-reference
rvm	tag	rvm
rxjs	tag	rxjs
rxjs-observables	tag	rxjs-observables
saddlepoint-approximation	tag	saddlepoint-approximation
safari	tag	safari
same-origin-policy	tag	same-origin-policy
sample	tag	sample
sample-size	tag	sample-size
sampling	tag	sampling
sankey-diagram	tag	sankey-diagram
sapply	tag	sapply
sas	tag	sas
sass	tag	sass
save	tag	save
scaffolding	tag	scaffolding
scala	tag	scala
scala-2.8	tag	scala-2.8
scala-collections	tag	scala-collections
scalability	tag	scalability
scale	tag	scale
scale-construction	tag	scale-construction
scales	tag	scales
scatterplot	tag	scatterplot
scheduled-tasks	tag	scheduled-tasks
schema	tag	schema
schoenfeld-residuals	tag	schoenfeld-residuals
scikit-learn	tag	scikit-learn
scipy	tag	scipy
scope	tag	scope
scoping	tag	scoping
scoring-rules	tag	scoring-rules
scp	tag	scp
screen	tag	screen
screen-density	tag	screen-density
screenshot	tag	screenshot
scripting	tag	scripting
scriptlet	tag	scriptlet
scroll	tag	scroll
scrollbar	tag	scrollbar
sdk	tag	sdk
search	tag	search
search-engine	tag	search-engine
seasonality	tag	seasonality
security	tag	security
sed	tag	sed
segmentation-fault	tag	segmentation-fault
select	tag	select
select-n-plus-1	tag	select-n-plus-1
selected	tag	selected
selectiveinference	tag	selectiveinference
selector	tag	selector
selenium	tag	selenium
selenium-shutterbug	tag	selenium-shutterbug
selenium-webdriver	tag	selenium-webdriver
self	tag	self
self-invoking-function	tag	self-invoking-function
self-organizing-maps	tag	self-organizing-maps
self-signed	tag	self-signed
self-study	tag	self-study
sem	tag	sem
semantic-markup	tag	semantic-markup
semantic-versioning	tag	semantic-versioning
semantics	tag	semantics
semaphore	tag	semaphore
semi-supervised	tag	semi-supervised
semiparametric	tag	semiparametric
sensitivity-analysis	tag	sensitivity-analysis
sensitivity-specificity	tag	sensitivity-specificity
sentiment-analysis	tag	sentiment-analysis
seo	tag	seo
separation	tag	separation
sequence	tag	sequence
sequence-analysis	tag	sequence-analysis
sequence-points	tag	sequence-points
sequential-analysis	tag	sequential-analysis
serializable	tag	serializable
serialization	tag	serialization
serialversionuid	tag	serialversionuid
server	tag	server
server-sent-events	tag	server-sent-events
server-side	tag	server-side
server-variables	tag	server-variables
serverside-javascript	tag	serverside-javascript
servlets	tag	servlets
session	tag	session
session-state	tag	session-state
session-storage	tag	session-storage
session-variables	tag	session-variables
set	tag	set
set-difference	tag	set-difference
setinterval	tag	setinterval
setter	tag	setter
settimeout	tag	settimeout
settings	tag	settings
setup.py	tag	setup.py
setuptools	tag	setuptools
sfinae	tag	sfinae
sgd	tag	sgd
sh	tag	sh
shallow-copy	tag	shallow-copy
shape	tag	shape
shapes	tag	shapes
shapley-value	tag	shapley-value
shared-libraries	tag	shared-libraries
shared-ptr	tag	shared-ptr
sharedpreferences	tag	sharedpreferences
shebang	tag	shebang
shell	tag	shell
shorthand	tag	shorthand
shrinkage	tag	shrinkage
shuffle	tag	shuffle
shutdown	tag	shutdown
siebel	tag	siebel
sigma-algebra	tag	sigma-algebra
sigmoid-curve	tag	sigmoid-curve
signal-detection	tag	signal-detection
signal-processing	tag	signal-processing
signals	tag	signals
signed	tag	signed
similarities	tag	similarities
simplehttpserver	tag	simplehttpserver
simpsons-paradox	tag	simpsons-paradox
simulation	tag	simulation
single-file	tag	single-file
single-quotes	tag	single-quotes
singleton	tag	singleton
singular	tag	singular
size	tag	size
size-t	tag	size-t
sizeof	tag	sizeof
sizzle	tag	sizzle
skellam	tag	skellam
skewness	tag	skewness
skinning	tag	skinning
skip	tag	skip
sleep	tag	sleep
slf4j	tag	slf4j
slice	tag	slice
slots	tag	slots
slowcheetah	tag	slowcheetah
slug	tag	slug
small-area-estimation	tag	small-area-estimation
small-sample	tag	small-sample
smart-pointers	tag	smart-pointers
smoothing	tag	smoothing
sms	tag	sms
smtp	tag	smtp
soa	tag	soa
soap	tag	soap
social-network	tag	social-network
sockets	tag	sockets
soft-keyboard	tag	soft-keyboard
soft-references	tag	soft-references
softmax	tag	softmax
software	tag	software
software-distribution	tag	software-distribution
software-update	tag	software-update
solid-principles	tag	solid-principles
solr	tag	solr
sorting	tag	sorting
source-code-protection	tag	source-code-protection
spaces	tag	spaces
sparse	tag	sparse
sparse-checkout	tag	sparse-checkout
spatial	tag	spatial
spatio-temporal	tag	spatio-temporal
spearman-rho	tag	spearman-rho
specifications	tag	specifications
spectral-analysis	tag	spectral-analysis
sphericity	tag	sphericity
splash-screen	tag	splash-screen
splines	tag	splines
split	tag	split
spring	tag	spring
spring-3	tag	spring-3
spring-boot	tag	spring-boot
spring-data	tag	spring-data
spring-data-jpa	tag	spring-data-jpa
spring-mvc	tag	spring-mvc
spss	tag	spss
spurious-correlation	tag	spurious-correlation
sql	tag	sql
sql-delete	tag	sql-delete
sql-function	tag	sql-function
sql-injection	tag	sql-injection
sql-insert	tag	sql-insert
sql-like	tag	sql-like
sql-limit	tag	sql-limit
sql-merge	tag	sql-merge
sql-order-by	tag	sql-order-by
sql-server	tag	sql-server
sql-server-2000	tag	sql-server-2000
sql-server-2005	tag	sql-server-2005
sql-server-2008	tag	sql-server-2008
sql-server-2012	tag	sql-server-2012
sql-server-2016	tag	sql-server-2016
sql-update	tag	sql-update
sqldatatypes	tag	sqldatatypes
sqlite	tag	sqlite
squash	tag	squash
src	tag	src
ssh	tag	ssh
ssh-agent	tag	ssh-agent
ssh-keys	tag	ssh-keys
ssl	tag	ssl
ssl-certificate	tag	ssl-certificate
ssms	tag	ssms
stack	tag	stack
stack-trace	tag	stack-trace
stacking	tag	stacking
staging	tag	staging
stan	tag	stan
standard-deviation	tag	standard-deviation
standard-error	tag	standard-error
standard-layout	tag	standard-layout
standard-library	tag	standard-library
standardization	tag	standardization
standards	tag	standards
standards-compliance	tag	standards-compliance
startactivityforresult	tag	startactivityforresult
starting-values	tag	starting-values
startswith	tag	startswith
stata	tag	stata
state	tag	state
state-space-models	tag	state-space-models
static	tag	static
static-classes	tag	static-classes
static-files	tag	static-files
static-libraries	tag	static-libraries
static-members	tag	static-members
static-methods	tag	static-methods
static-typing	tag	static-typing
stationarity	tag	stationarity
statistical-learning	tag	statistical-learning
statistical-significance	tag	statistical-significance
statistics	tag	statistics
statistics-in-media	tag	statistics-in-media
statsmodels	tag	statsmodels
statusbar	tag	statusbar
std	tag	std
std-pair	tag	std-pair
stdafx.h	tag	stdafx.h
stdclass	tag	stdclass
stderr	tag	stderr
stdin	tag	stdin
stdmove	tag	stdmove
stdout	tag	stdout
stdstring	tag	stdstring
stdvector	tag	stdvector
steins-phenomenon	tag	steins-phenomenon
stepwise-regression	tag	stepwise-regression
stl	tag	stl
stochastic-processes	tag	stochastic-processes
stoppropagation	tag	stoppropagation
stopwatch	tag	stopwatch
stored-procedures	tag	stored-procedures
str-replace	tag	str-replace
stratification	tag	stratification
stream	tag	stream
streamreader	tag	streamreader
strftime	tag	strftime
strict-aliasing	tag	strict-aliasing
string	tag	string
string-comparison	tag	string-comparison
string-concatenation	tag	string-concatenation
string-formatting	tag	string-formatting
string-interpolation	tag	string-interpolation
string-matching	tag	string-matching
string-parsing	tag	string-parsing
string-split	tag	string-split
string.format	tag	string.format
stringbuffer	tag	stringbuffer
stringbuilder	tag	stringbuilder
stringstream	tag	stringstream
strip	tag	strip
struct	tag	struct
structural-change	tag	structural-change
stub	tag	stub
stylecop	tag	stylecop
styles	tag	styles
stylesheet	tag	stylesheet
styling	tag	styling
subclipse	tag	subclipse
subdirectory	tag	subdirectory
sublimetext	tag	sublimetext
sublimetext2	tag	sublimetext2
submit	tag	submit
subprocess	tag	subprocess
subquery	tag	subquery
subscription	tag	subscription
substr	tag	substr
substring	tag	substring
subversive	tag	subversive
sudo	tag	sudo
sufficient-statistics	tag	sufficient-statistics
suffix-tree	tag	suffix-tree
sum	tag	sum
summations	tag	summations
sums-of-squares	tag	sums-of-squares
super	tag	super
superclass	tag	superclass
supervised-learning	tag	supervised-learning
suppressor	tag	suppressor
surfaceview	tag	surfaceview
survey	tag	survey
survival	tag	survival
svd	tag	svd
svg	tag	svg
svm	tag	svm
svn	tag	svn
svn-export	tag	svn-export
swift	tag	swift
swift-protocols	tag	swift-protocols
swift4	tag	swift4
swing	tag	swing
switch-statement	tag	switch-statement
symbols	tag	symbols
symlink	tag	symlink
symmetry	tag	symmetry
synchronization	tag	synchronization
synchronized	tag	synchronized
synchronous	tag	synchronous
syntactic-sugar	tag	syntactic-sugar
syntax	tag	syntax
syntax-error	tag	syntax-error
syntax-highlighting	tag	syntax-highlighting
synthesize	tag	synthesize
synthetic-data	tag	synthetic-data
sysadmin	tag	sysadmin
system	tag	system
system-information	tag	system-information
system-tables	tag	system-tables
system.data.sqlite	tag	system.data.sqlite
system.diagnostics	tag	system.diagnostics
system.out	tag	system.out
t-distribution	tag	t-distribution
t-test	tag	t-test
table-structure	tag	table-structure
tables	tag	tables
tabs	tag	tabs
tags	tag	tags
tail	tag	tail
tail-call-optimization	tag	tail-call-optimization
tail-recursion	tag	tail-recursion
takesscreenshot	tag	takesscreenshot
tapply	tag	tapply
tar	tag	tar
targeted-maximum-likelihood	tag	targeted-maximum-likelihood
task-parallel-library	tag	task-parallel-library
taylor-series	tag	taylor-series
tbats	tag	tbats
tcp	tag	tcp
tcsh	tag	tcsh
tdd	tag	tdd
teaching	tag	teaching
temp-tables	tag	temp-tables
template-meta-programming	tag	template-meta-programming
templates	tag	templates
temporary-files	tag	temporary-files
tensor	tag	tensor
tensorflow	tag	tensorflow
terminal	tag	terminal
terminal-color	tag	terminal-color
terminate	tag	terminate
termination	tag	termination
terminology	tag	terminology
ternary-operator	tag	ternary-operator
testflight	tag	testflight
testing	tag	testing
text	tag	text
text-align	tag	text-align
text-alignment	tag	text-alignment
text-editor	tag	text-editor
text-files	tag	text-files
text-formatting	tag	text-formatting
text-mining	tag	text-mining
text-parsing	tag	text-parsing
text-processing	tag	text-processing
text-segmentation	tag	text-segmentation
textarea	tag	textarea
textbox	tag	textbox
textinput	tag	textinput
textselection	tag	textselection
textview	tag	textview
tfs	tag	tfs
tfs-workitem	tag	tfs-workitem
theano	tag	theano
themes	tag	themes
theory	tag	theory
this	tag	this
thread-confinement	tag	thread-confinement
thread-local	tag	thread-local
thread-safety	tag	thread-safety
threadcontext	tag	threadcontext
three.js	tag	three.js
threshold	tag	threshold
ties	tag	ties
tikhonov-regularization	tag	tikhonov-regularization
time	tag	time
time-complexity	tag	time-complexity
time-format	tag	time-format
time-series	tag	time-series
timedelay	tag	timedelay
timeit	tag	timeit
timeout	tag	timeout
timer	tag	timer
timestamp	tag	timestamp
timezone	tag	timezone
timezone-offset	tag	timezone-offset
timing	tag	timing
title-case	tag	title-case
titlebar	tag	titlebar
tobit-regression	tag	tobit-regression
token	tag	token
tolerance-interval	tag	tolerance-interval
tolower	tag	tolower
tomcat	tag	tomcat
tooltip	tag	tooltip
topic-models	tag	topic-models
topologies	tag	topologies
tortoisesvn	tag	tortoisesvn
tost	tag	tost
tostring	tag	tostring
total-least-squares	tag	total-least-squares
trace	tag	trace
traceback	tag	traceback
trailing	tag	trailing
train	tag	train
training-error	tag	training-error
transaction-log	tag	transaction-log
transactions	tag	transactions
transfer-learning	tag	transfer-learning
transform	tag	transform
transient	tag	transient
transitive-dependency	tag	transitive-dependency
transparency	tag	transparency
transparent	tag	transparent
transportation	tag	transportation
transpose	tag	transpose
travis-ci	tag	travis-ci
treatment-effect	tag	treatment-effect
tree	tag	tree
treeset	tag	treeset
trello	tag	trello
trend	tag	trend
triggers	tag	triggers
trigraphs	tag	trigraphs
trim	tag	trim
trimmed-mean	tag	trimmed-mean
truncate	tag	truncate
truncation	tag	truncation
trunk	tag	trunk
try-catch	tag	try-catch
try-catch-finally	tag	try-catch-finally
try-except	tag	try-except
tslint	tag	tslint
tsne	tag	tsne
tsql	tag	tsql
tty	tag	tty
tukey-hsd	tag	tukey-hsd
tuples	tag	tuples
turing-complete	tag	turing-complete
turing-machines	tag	turing-machines
tweedie-distribution	tag	tweedie-distribution
twitter	tag	twitter
twitter-bootstrap	tag	twitter-bootstrap
twitter-bootstrap-3	tag	twitter-bootstrap-3
two-sample	tag	two-sample
type-conversion	tag	type-conversion
type-i-and-ii-errors	tag	type-i-and-ii-errors
type-punning	tag	type-punning
typedef	tag	typedef
typeface	tag	typeface
typename	tag	typename
typeof	tag	typeof
types	tag	types
types-of-averages	tag	types-of-averages
typescript	tag	typescript
uac	tag	uac
ubuntu	tag	ubuntu
ubuntu-14.04	tag	ubuntu-14.04
ubuntu-18.04	tag	ubuntu-18.04
ui-thread	tag	ui-thread
uibutton	tag	uibutton
uicolor	tag	uicolor
uidevice	tag	uidevice
uikeyboard	tag	uikeyboard
uikit	tag	uikit
uilabel	tag	uilabel
uiscrollview	tag	uiscrollview
uistatusbar	tag	uistatusbar
uistoryboard	tag	uistoryboard
uitableview	tag	uitableview
uitextfield	tag	uitextfield
uitextfielddelegate	tag	uitextfielddelegate
uitextview	tag	uitextview
uiview	tag	uiview
uiviewcontroller	tag	uiviewcontroller
uiwindow	tag	uiwindow
uml	tag	uml
umvue	tag	umvue
unbalanced-classes	tag	unbalanced-classes
unbiased-estimator	tag	unbiased-estimator
uncertainty	tag	uncertainty
unchecked-exception	tag	unchecked-exception
undefined	tag	undefined
undefined-behavior	tag	undefined-behavior
undefined-index	tag	undefined-index
undefined-reference	tag	undefined-reference
underdetermined	tag	underdetermined
underdispersion	tag	underdispersion
underline	tag	underline
underscore.js	tag	underscore.js
undo	tag	undo
unevenly-spaced-time-series	tag	unevenly-spaced-time-series
unicode	tag	unicode
uniform	tag	uniform
uninformative-prior	tag	uninformative-prior
union	tag	union
union-all	tag	union-all
unique	tag	unique
unique-constraint	tag	unique-constraint
uniqueidentifier	tag	uniqueidentifier
unit-root	tag	unit-root
unit-testing	tag	unit-testing
units	tag	units
units-of-measurement	tag	units-of-measurement
unity3d	tag	unity3d
universal-image-loader	tag	universal-image-loader
unix	tag	unix
unix-timestamp	tag	unix-timestamp
unlink	tag	unlink
unobtrusive-javascript	tag	unobtrusive-javascript
unresolved-external	tag	unresolved-external
unset	tag	unset
unsigned	tag	unsigned
unspecified-behavior	tag	unspecified-behavior
unsupervised-learning	tag	unsupervised-learning
unsupported-class-version	tag	unsupported-class-version
upgrade	tag	upgrade
upload	tag	upload
uppercase	tag	uppercase
upsert	tag	upsert
uri	tag	uri
url	tag	url
url-encoding	tag	url-encoding
url-parameters	tag	url-parameters
url-protocol	tag	url-protocol
url-rewriting	tag	url-rewriting
urlconnection	tag	urlconnection
urlencode	tag	urlencode
urllib	tag	urllib
urllib2	tag	urllib2
urn	tag	urn
use-case	tag	use-case
use-strict	tag	use-strict
user-agent	tag	user-agent
user-input	tag	user-input
user-interface	tag	user-interface
usermanager	tag	usermanager
username	tag	username
using-declaration	tag	using-declaration
using-directives	tag	using-directives
utc	tag	utc
utf	tag	utf
utf-16	tag	utf-16
utf-32	tag	utf-32
utf-8	tag	utf-8
uuid	tag	uuid
v8	tag	v8
vagrant	tag	vagrant
validation	tag	validation
validity	tag	validity
valuation	tag	valuation
value-type	tag	value-type
var	tag	var
var-dump	tag	var-dump
varchar	tag	varchar
variability	tag	variability
variable-assignment	tag	variable-assignment
variables	tag	variables
variadic-functions	tag	variadic-functions
variance	tag	variance
variance-decomposition	tag	variance-decomposition
variance-stabilizing	tag	variance-stabilizing
variational-bayes	tag	variational-bayes
vb.net	tag	vb.net
vba	tag	vba
vc-dimension	tag	vc-dimension
vecm	tag	vecm
vector	tag	vector
vector-graphics	tag	vector-graphics
vectorization	tag	vectorization
verbatim-string	tag	verbatim-string
verification	tag	verification
version	tag	version
version-control	tag	version-control
versioning	tag	versioning
vertical-alignment	tag	vertical-alignment
vi	tag	vi
vibration	tag	vibration
video	tag	video
video-editing	tag	video-editing
view	tag	view
viewcontroller	tag	viewcontroller
viewer	tag	viewer
viewport	tag	viewport
views	tag	views
vif	tag	vif
vim	tag	vim
vim-macros	tag	vim-macros
virtual-destructor	tag	virtual-destructor
virtual-functions	tag	virtual-functions
virtual-machine	tag	virtual-machine
virtualbox	tag	virtualbox
virtualenv	tag	virtualenv
virtualenv-commands	tag	virtualenv-commands
virtualenvwrapper	tag	virtualenvwrapper
virtualization	tag	virtualization
visibility	tag	visibility
visual-c++	tag	visual-c++
visual-studio	tag	visual-studio
visual-studio-2008	tag	visual-studio-2008
visual-studio-2010	tag	visual-studio-2010
visual-studio-2012	tag	visual-studio-2012
visual-studio-2013	tag	visual-studio-2013
visual-studio-code	tag	visual-studio-code
visualization	tag	visualization
viterbi-algorithm	tag	viterbi-algorithm
void	tag	void
volatile	tag	volatile
von-mises-distribution	tag	von-mises-distribution
voting-system	tag	voting-system
vowpal-wabbit	tag	vowpal-wabbit
vs-unit-testing-framework	tag	vs-unit-testing-framework
vscode-settings	tag	vscode-settings
w3c	tag	w3c
w3c-validation	tag	w3c-validation
wait	tag	wait
wallpaper	tag	wallpaper
ward	tag	ward
warnings	tag	warnings
wasserstein	tag	wasserstein
wavelet	tag	wavelet
wcf	tag	wcf
weak-references	tag	weak-references
web	tag	web
web-applications	tag	web-applications
web-config-transform	tag	web-config-transform
web-inspector	tag	web-inspector
web-services	tag	web-services
webdriver	tag	webdriver
webkit	tag	webkit
webmatrix	tag	webmatrix
webpack	tag	webpack
webserver	tag	webserver
websocket	tag	websocket
websphere	tag	websphere
webstorm	tag	webstorm
weekday	tag	weekday
weibull	tag	weibull
weighted-data	tag	weighted-data
weighted-mean	tag	weighted-mean
weighted-regression	tag	weighted-regression
weighted-sampling	tag	weighted-sampling
weights	tag	weights
weka	tag	weka
werkzeug	tag	werkzeug
wget	tag	wget
where-clause	tag	where-clause
where-in	tag	where-in
while-loop	tag	while-loop
white-noise	tag	white-noise
whitening	tag	whitening
whitespace	tag	whitespace
widget	tag	widget
width	tag	width
wifi	tag	wifi
wilcoxon-mann-whitney	tag	wilcoxon-mann-whitney
wilcoxon-signed-rank	tag	wilcoxon-signed-rank
wildcard	tag	wildcard
winbugs	tag	winbugs
window	tag	window
window-resize	tag	window-resize
windows	tag	windows
windows-7	tag	windows-7
windows-7-x64	tag	windows-7-x64
windows-8	tag	windows-8
windows-runtime	tag	windows-runtime
windows-server-2003	tag	windows-server-2003
windows-server-2008-r2	tag	windows-server-2008-r2
windows-services	tag	windows-services
windows-xp	tag	windows-xp
winforms	tag	winforms
winsorizing	tag	winsorizing
wishart	tag	wishart
woff	tag	woff
wolfram-mathematica	tag	wolfram-mathematica
word-embeddings	tag	word-embeddings
word-wrap	tag	word-wrap
word2vec	tag	word2vec
wordpress	tag	wordpress
words	tag	words
workflow	tag	workflow
working-directory	tag	working-directory
wpf	tag	wpf
wsdl	tag	wsdl
wsdl2java	tag	wsdl2java
wsh	tag	wsh
wstring	tag	wstring
x-ua-compatible	tag	x-ua-compatible
x509certificate	tag	x509certificate
x86	tag	x86
x86-16	tag	x86-16
x86-64	tag	x86-64
xamarin	tag	xamarin
xaml	tag	xaml
xcode	tag	xcode
xcode10	tag	xcode10
xcode4	tag	xcode4
xcode4.3	tag	xcode4.3
xcode6	tag	xcode6
xcode7	tag	xcode7
xcode8	tag	xcode8
xcode9-beta	tag	xcode9-beta
xerces	tag	xerces
xgboost	tag	xgboost
xhtml	tag	xhtml
xib	tag	xib
xml	tag	xml
xml-parsing	tag	xml-parsing
xml-rpc	tag	xml-rpc
xmldocument	tag	xmldocument
xmlgregoriancalendar	tag	xmlgregoriancalendar
xmlhttprequest	tag	xmlhttprequest
xrange	tag	xrange
xss	tag	xss
xticks	tag	xticks
yaml	tag	yaml
yield	tag	yield
yield-return	tag	yield-return
yolo	tag	yolo
youtube	tag	youtube
youtube-api	tag	youtube-api
youtube-data-api	tag	youtube-data-api
z-index	tag	z-index
z-score	tag	z-score
z-statistic	tag	z-statistic
z-test	tag	z-test
zalgo	tag	zalgo
zen-of-python	tag	zen-of-python
zero-inflation	tag	zero-inflation
zero-pad	tag	zero-pad
zero-padding	tag	zero-padding
zeromq	tag	zeromq
zip	tag	zip
zipf	tag	zipf
zipfile	tag	zipfile
zlib	tag	zlib
zoom	tag	zoom
zsh	tag	zsh
